code,barrio_name,edad,hombres,mujeres,total,g_edad
06028,Almirante Brown,0,5052,4690,9742,edad 0
06028,Almirante Brown,1,4510,4350,8860,edad 0
06028,Almirante Brown,2,5132,5004,10136,edad 0
06028,Almirante Brown,3,5191,4957,10148,edad 0
06028,Almirante Brown,4,5228,4963,10191,edad 0
06028,Almirante Brown,5,5282,5198,10480,edad 0
06028,Almirante Brown,6,5268,5065,10333,edad 0
06028,Almirante Brown,7,5210,4919,10129,edad 0
06028,Almirante Brown,8,5199,5002,10201,edad 0
06028,Almirante Brown,9,5195,5121,10316,edad 0
06028,Almirante Brown,10,5470,5317,10787,edad 10
06028,Almirante Brown,11,5431,5120,10551,edad 10
06028,Almirante Brown,12,5162,5031,10193,edad 10
06028,Almirante Brown,13,5188,4966,10154,edad 10
06028,Almirante Brown,14,5077,5128,10205,edad 10
06028,Almirante Brown,15,4997,4883,9880,edad 10
06028,Almirante Brown,16,4841,4688,9529,edad 10
06028,Almirante Brown,17,4662,4452,9114,edad 10
06028,Almirante Brown,18,4656,4570,9226,edad 10
06028,Almirante Brown,19,4837,4919,9756,edad 10
06028,Almirante Brown,20,4810,4747,9557,edad 20
06028,Almirante Brown,21,5095,4848,9943,edad 20
06028,Almirante Brown,22,4656,4629,9285,edad 20
06028,Almirante Brown,23,4635,4583,9218,edad 20
06028,Almirante Brown,24,4333,4503,8836,edad 20
06028,Almirante Brown,25,4139,4214,8353,edad 20
06028,Almirante Brown,26,3904,3990,7894,edad 20
06028,Almirante Brown,27,3601,3769,7370,edad 20
06028,Almirante Brown,28,3740,3802,7542,edad 20
06028,Almirante Brown,29,3606,3715,7321,edad 20
06028,Almirante Brown,30,3785,3948,7733,edad 30
06028,Almirante Brown,31,3494,3674,7168,edad 30
06028,Almirante Brown,32,3508,3600,7108,edad 30
06028,Almirante Brown,33,3346,3484,6830,edad 30
06028,Almirante Brown,34,3087,3172,6259,edad 30
06028,Almirante Brown,35,3168,3352,6520,edad 30
06028,Almirante Brown,36,3242,3417,6659,edad 30
06028,Almirante Brown,37,3109,3259,6368,edad 30
06028,Almirante Brown,38,3243,3374,6617,edad 30
06028,Almirante Brown,39,3120,3205,6325,edad 30
06028,Almirante Brown,40,3144,3462,6606,edad 40
06028,Almirante Brown,41,3107,3162,6269,edad 40
06028,Almirante Brown,42,3127,3304,6431,edad 40
06028,Almirante Brown,43,3042,3104,6146,edad 40
06028,Almirante Brown,44,2803,2771,5574,edad 40
06028,Almirante Brown,45,2891,3065,5956,edad 40
06028,Almirante Brown,46,2741,2953,5694,edad 40
06028,Almirante Brown,47,2845,2987,5832,edad 40
06028,Almirante Brown,48,2751,2839,5590,edad 40
06028,Almirante Brown,49,2611,2696,5307,edad 40
06028,Almirante Brown,50,2639,2931,5570,edad 50
06028,Almirante Brown,51,2490,2636,5126,edad 50
06028,Almirante Brown,52,2462,2688,5150,edad 50
06028,Almirante Brown,53,2387,2485,4872,edad 50
06028,Almirante Brown,54,1999,2338,4337,edad 50
06028,Almirante Brown,55,2064,2292,4356,edad 50
06028,Almirante Brown,56,2180,2316,4496,edad 50
06028,Almirante Brown,57,1917,2090,4007,edad 50
06028,Almirante Brown,58,1809,2081,3890,edad 50
06028,Almirante Brown,59,1526,1807,3333,edad 50
06028,Almirante Brown,60,1768,1996,3764,edad 60
06028,Almirante Brown,61,1512,1753,3265,edad 60
06028,Almirante Brown,62,1548,1791,3339,edad 60
06028,Almirante Brown,63,1419,1696,3115,edad 60
06028,Almirante Brown,64,1389,1642,3031,edad 60
06028,Almirante Brown,65,1452,1745,3197,edad 60
06028,Almirante Brown,66,1271,1519,2790,edad 60
06028,Almirante Brown,67,1272,1462,2734,edad 60
06028,Almirante Brown,68,1261,1436,2697,edad 60
06028,Almirante Brown,69,1107,1450,2557,edad 60
06028,Almirante Brown,70,1197,1599,2796,edad 70
06028,Almirante Brown,71,1061,1421,2482,edad 70
06028,Almirante Brown,72,1020,1344,2364,edad 70
06028,Almirante Brown,73,963,1295,2258,edad 70
06028,Almirante Brown,74,890,1215,2105,edad 70
06028,Almirante Brown,75,744,1193,1937,edad 70
06028,Almirante Brown,76,778,1071,1849,edad 70
06028,Almirante Brown,77,610,976,1586,edad 70
06028,Almirante Brown,78,586,941,1527,edad 70
06028,Almirante Brown,79,486,728,1214,edad 70
06028,Almirante Brown,80,427,779,1206,edad 80
06028,Almirante Brown,81,334,658,992,edad 80
06028,Almirante Brown,82,309,596,905,edad 80
06028,Almirante Brown,83,227,491,718,edad 80
06028,Almirante Brown,84,228,445,673,edad 80
06028,Almirante Brown,85,142,366,508,edad 80
06028,Almirante Brown,86,152,362,514,edad 80
06028,Almirante Brown,87,137,337,474,edad 80
06028,Almirante Brown,88,110,273,383,edad 80
06028,Almirante Brown,89,74,215,289,edad 80
06028,Almirante Brown,90,64,176,240,edad 90
06028,Almirante Brown,91,43,115,158,edad 90
06028,Almirante Brown,92,39,99,138,edad 90
06028,Almirante Brown,93,31,89,120,edad 90
06028,Almirante Brown,94,17,55,72,edad 90
06028,Almirante Brown,95,16,49,65,edad 90
06028,Almirante Brown,96,10,29,39,edad 90
06028,Almirante Brown,97,6,23,29,edad 90
06028,Almirante Brown,98,4,16,20,edad 90
06028,Almirante Brown,99,5,5,10,edad 90
06035,Avellaneda,0,2490,2529,5019,edad 0
06035,Avellaneda,1,2343,2274,4617,edad 0
06035,Avellaneda,2,2534,2452,4986,edad 0
06035,Avellaneda,3,2346,2292,4638,edad 0
06035,Avellaneda,4,2347,2332,4679,edad 0
06035,Avellaneda,5,2503,2411,4914,edad 0
06035,Avellaneda,6,2378,2326,4704,edad 0
06035,Avellaneda,7,2337,2324,4661,edad 0
06035,Avellaneda,8,2365,2246,4611,edad 0
06035,Avellaneda,9,2374,2352,4726,edad 0
06035,Avellaneda,10,2550,2520,5070,edad 10
06035,Avellaneda,11,2462,2381,4843,edad 10
06035,Avellaneda,12,2525,2477,5002,edad 10
06035,Avellaneda,13,2445,2516,4961,edad 10
06035,Avellaneda,14,2568,2411,4979,edad 10
06035,Avellaneda,15,2570,2480,5050,edad 10
06035,Avellaneda,16,2494,2450,4944,edad 10
06035,Avellaneda,17,2481,2409,4890,edad 10
06035,Avellaneda,18,2526,2405,4931,edad 10
06035,Avellaneda,19,2581,2789,5370,edad 10
06035,Avellaneda,20,2581,2673,5254,edad 20
06035,Avellaneda,21,2938,2874,5812,edad 20
06035,Avellaneda,22,2776,2838,5614,edad 20
06035,Avellaneda,23,2739,2868,5607,edad 20
06035,Avellaneda,24,2808,2887,5695,edad 20
06035,Avellaneda,25,2647,2709,5356,edad 20
06035,Avellaneda,26,2619,2672,5291,edad 20
06035,Avellaneda,27,2468,2418,4886,edad 20
06035,Avellaneda,28,2434,2417,4851,edad 20
06035,Avellaneda,29,2209,2359,4568,edad 20
06035,Avellaneda,30,2447,2437,4884,edad 30
06035,Avellaneda,31,2187,2325,4512,edad 30
06035,Avellaneda,32,2173,2216,4389,edad 30
06035,Avellaneda,33,2140,2178,4318,edad 30
06035,Avellaneda,34,1794,2104,3898,edad 30
06035,Avellaneda,35,2029,2140,4169,edad 30
06035,Avellaneda,36,1955,2099,4054,edad 30
06035,Avellaneda,37,1921,2054,3975,edad 30
06035,Avellaneda,38,1993,2175,4168,edad 30
06035,Avellaneda,39,1997,2110,4107,edad 30
06035,Avellaneda,40,1942,2159,4101,edad 40
06035,Avellaneda,41,1974,2162,4136,edad 40
06035,Avellaneda,42,2082,2162,4244,edad 40
06035,Avellaneda,43,2032,2152,4184,edad 40
06035,Avellaneda,44,1877,1981,3858,edad 40
06035,Avellaneda,45,1882,2189,4071,edad 40
06035,Avellaneda,46,1915,2199,4114,edad 40
06035,Avellaneda,47,1780,2026,3806,edad 40
06035,Avellaneda,48,1865,2146,4011,edad 40
06035,Avellaneda,49,1770,1861,3631,edad 40
06035,Avellaneda,50,1958,2285,4243,edad 50
06035,Avellaneda,51,1769,2139,3908,edad 50
06035,Avellaneda,52,1780,2056,3836,edad 50
06035,Avellaneda,53,1800,1935,3735,edad 50
06035,Avellaneda,54,1626,1824,3450,edad 50
06035,Avellaneda,55,1566,1907,3473,edad 50
06035,Avellaneda,56,1703,1884,3587,edad 50
06035,Avellaneda,57,1507,1801,3308,edad 50
06035,Avellaneda,58,1496,1778,3274,edad 50
06035,Avellaneda,59,1249,1601,2850,edad 50
06035,Avellaneda,60,1399,1815,3214,edad 60
06035,Avellaneda,61,1271,1577,2848,edad 60
06035,Avellaneda,62,1286,1583,2869,edad 60
06035,Avellaneda,63,1260,1580,2840,edad 60
06035,Avellaneda,64,1255,1499,2754,edad 60
06035,Avellaneda,65,1321,1671,2992,edad 60
06035,Avellaneda,66,1149,1566,2715,edad 60
06035,Avellaneda,67,1098,1436,2534,edad 60
06035,Avellaneda,68,1079,1556,2635,edad 60
06035,Avellaneda,69,1111,1504,2615,edad 60
06035,Avellaneda,70,1127,1762,2889,edad 70
06035,Avellaneda,71,1090,1584,2674,edad 70
06035,Avellaneda,72,1035,1561,2596,edad 70
06035,Avellaneda,73,978,1520,2498,edad 70
06035,Avellaneda,74,910,1448,2358,edad 70
06035,Avellaneda,75,840,1458,2298,edad 70
06035,Avellaneda,76,829,1390,2219,edad 70
06035,Avellaneda,77,738,1251,1989,edad 70
06035,Avellaneda,78,695,1193,1888,edad 70
06035,Avellaneda,79,593,966,1559,edad 70
06035,Avellaneda,80,497,1036,1533,edad 80
06035,Avellaneda,81,420,789,1209,edad 80
06035,Avellaneda,82,340,714,1054,edad 80
06035,Avellaneda,83,261,592,853,edad 80
06035,Avellaneda,84,234,555,789,edad 80
06035,Avellaneda,85,199,492,691,edad 80
06035,Avellaneda,86,184,473,657,edad 80
06035,Avellaneda,87,166,407,573,edad 80
06035,Avellaneda,88,115,323,438,edad 80
06035,Avellaneda,89,93,281,374,edad 80
06035,Avellaneda,90,56,212,268,edad 90
06035,Avellaneda,91,57,162,219,edad 90
06035,Avellaneda,92,30,116,146,edad 90
06035,Avellaneda,93,38,94,132,edad 90
06035,Avellaneda,94,22,55,77,edad 90
06035,Avellaneda,95,8,48,56,edad 90
06035,Avellaneda,96,9,24,33,edad 90
06035,Avellaneda,97,4,22,26,edad 90
06035,Avellaneda,98,2,15,17,edad 90
06035,Avellaneda,99,3,14,17,edad 90
06091,Berazategui,0,2923,2706,5629,edad 0
06091,Berazategui,1,2535,2490,5025,edad 0
06091,Berazategui,2,2890,2807,5697,edad 0
06091,Berazategui,3,2793,2629,5422,edad 0
06091,Berazategui,4,2795,2654,5449,edad 0
06091,Berazategui,5,2931,2802,5733,edad 0
06091,Berazategui,6,2751,2865,5616,edad 0
06091,Berazategui,7,2720,2649,5369,edad 0
06091,Berazategui,8,2755,2654,5409,edad 0
06091,Berazategui,9,2792,2713,5505,edad 0
06091,Berazategui,10,2956,2948,5904,edad 10
06091,Berazategui,11,2854,2840,5694,edad 10
06091,Berazategui,12,2834,2659,5493,edad 10
06091,Berazategui,13,2708,2712,5420,edad 10
06091,Berazategui,14,2763,2742,5505,edad 10
06091,Berazategui,15,2658,2624,5282,edad 10
06091,Berazategui,16,2543,2444,4987,edad 10
06091,Berazategui,17,2448,2457,4905,edad 10
06091,Berazategui,18,2534,2493,5027,edad 10
06091,Berazategui,19,2650,2630,5280,edad 10
06091,Berazategui,20,2601,2657,5258,edad 20
06091,Berazategui,21,2739,2704,5443,edad 20
06091,Berazategui,22,2819,2746,5565,edad 20
06091,Berazategui,23,2634,2634,5268,edad 20
06091,Berazategui,24,2624,2632,5256,edad 20
06091,Berazategui,25,2316,2413,4729,edad 20
06091,Berazategui,26,2171,2269,4440,edad 20
06091,Berazategui,27,2173,2191,4364,edad 20
06091,Berazategui,28,2198,2306,4504,edad 20
06091,Berazategui,29,2145,2100,4245,edad 20
06091,Berazategui,30,2245,2458,4703,edad 30
06091,Berazategui,31,2068,2129,4197,edad 30
06091,Berazategui,32,1984,2058,4042,edad 30
06091,Berazategui,33,1912,1987,3899,edad 30
06091,Berazategui,34,1803,1841,3644,edad 30
06091,Berazategui,35,1821,1931,3752,edad 30
06091,Berazategui,36,1860,1941,3801,edad 30
06091,Berazategui,37,1733,1899,3632,edad 30
06091,Berazategui,38,1817,1869,3686,edad 30
06091,Berazategui,39,1610,1725,3335,edad 30
06091,Berazategui,40,1734,1772,3506,edad 40
06091,Berazategui,41,1773,1692,3465,edad 40
06091,Berazategui,42,1776,1725,3501,edad 40
06091,Berazategui,43,1687,1678,3365,edad 40
06091,Berazategui,44,1465,1643,3108,edad 40
06091,Berazategui,45,1613,1680,3293,edad 40
06091,Berazategui,46,1542,1709,3251,edad 40
06091,Berazategui,47,1436,1646,3082,edad 40
06091,Berazategui,48,1526,1685,3211,edad 40
06091,Berazategui,49,1418,1580,2998,edad 40
06091,Berazategui,50,1663,1686,3349,edad 50
06091,Berazategui,51,1427,1528,2955,edad 50
06091,Berazategui,52,1448,1547,2995,edad 50
06091,Berazategui,53,1391,1420,2811,edad 50
06091,Berazategui,54,1301,1434,2735,edad 50
06091,Berazategui,55,1259,1276,2535,edad 50
06091,Berazategui,56,1342,1401,2743,edad 50
06091,Berazategui,57,1133,1186,2319,edad 50
06091,Berazategui,58,1118,1241,2359,edad 50
06091,Berazategui,59,972,1044,2016,edad 50
06091,Berazategui,60,1042,1213,2255,edad 60
06091,Berazategui,61,952,957,1909,edad 60
06091,Berazategui,62,892,1038,1930,edad 60
06091,Berazategui,63,881,986,1867,edad 60
06091,Berazategui,64,802,899,1701,edad 60
06091,Berazategui,65,896,977,1873,edad 60
06091,Berazategui,66,748,850,1598,edad 60
06091,Berazategui,67,696,816,1512,edad 60
06091,Berazategui,68,604,855,1459,edad 60
06091,Berazategui,69,632,786,1418,edad 60
06091,Berazategui,70,668,848,1516,edad 70
06091,Berazategui,71,629,813,1442,edad 70
06091,Berazategui,72,542,756,1298,edad 70
06091,Berazategui,73,535,655,1190,edad 70
06091,Berazategui,74,476,682,1158,edad 70
06091,Berazategui,75,435,633,1068,edad 70
06091,Berazategui,76,400,585,985,edad 70
06091,Berazategui,77,327,484,811,edad 70
06091,Berazategui,78,336,511,847,edad 70
06091,Berazategui,79,276,405,681,edad 70
06091,Berazategui,80,227,399,626,edad 80
06091,Berazategui,81,225,316,541,edad 80
06091,Berazategui,82,144,281,425,edad 80
06091,Berazategui,83,141,235,376,edad 80
06091,Berazategui,84,88,195,283,edad 80
06091,Berazategui,85,105,195,300,edad 80
06091,Berazategui,86,80,177,257,edad 80
06091,Berazategui,87,66,141,207,edad 80
06091,Berazategui,88,42,130,172,edad 80
06091,Berazategui,89,29,92,121,edad 80
06091,Berazategui,90,35,62,97,edad 90
06091,Berazategui,91,14,46,60,edad 90
06091,Berazategui,92,21,41,62,edad 90
06091,Berazategui,93,17,38,55,edad 90
06091,Berazategui,94,9,25,34,edad 90
06091,Berazategui,95,4,10,14,edad 90
06091,Berazategui,96,7,8,15,edad 90
06091,Berazategui,97,4,11,15,edad 90
06091,Berazategui,98,4,7,11,edad 90
06091,Berazategui,99,2,7,9,edad 90
06260,Esteban Echeverría,0,2535,2495,5030,edad 0
06260,Esteban Echeverría,1,2272,2303,4575,edad 0
06260,Esteban Echeverría,2,2611,2401,5012,edad 0
06260,Esteban Echeverría,3,2509,2393,4902,edad 0
06260,Esteban Echeverría,4,2678,2523,5201,edad 0
06260,Esteban Echeverría,5,2766,2678,5444,edad 0
06260,Esteban Echeverría,6,2564,2501,5065,edad 0
06260,Esteban Echeverría,7,2618,2501,5119,edad 0
06260,Esteban Echeverría,8,2492,2522,5014,edad 0
06260,Esteban Echeverría,9,2560,2448,5008,edad 0
06260,Esteban Echeverría,10,2623,2628,5251,edad 10
06260,Esteban Echeverría,11,2632,2463,5095,edad 10
06260,Esteban Echeverría,12,2462,2506,4968,edad 10
06260,Esteban Echeverría,13,2558,2430,4988,edad 10
06260,Esteban Echeverría,14,2412,2407,4819,edad 10
06260,Esteban Echeverría,15,2278,2299,4577,edad 10
06260,Esteban Echeverría,16,2207,2083,4290,edad 10
06260,Esteban Echeverría,17,2200,2190,4390,edad 10
06260,Esteban Echeverría,18,2146,2123,4269,edad 10
06260,Esteban Echeverría,19,2232,2319,4551,edad 10
06260,Esteban Echeverría,20,2248,2266,4514,edad 20
06260,Esteban Echeverría,21,2197,2343,4540,edad 20
06260,Esteban Echeverría,22,2268,2307,4575,edad 20
06260,Esteban Echeverría,23,2161,2181,4342,edad 20
06260,Esteban Echeverría,24,2160,2187,4347,edad 20
06260,Esteban Echeverría,25,1927,2105,4032,edad 20
06260,Esteban Echeverría,26,1841,2009,3850,edad 20
06260,Esteban Echeverría,27,1884,1958,3842,edad 20
06260,Esteban Echeverría,28,1905,1886,3791,edad 20
06260,Esteban Echeverría,29,1782,1888,3670,edad 20
06260,Esteban Echeverría,30,1943,2043,3986,edad 30
06260,Esteban Echeverría,31,1720,1834,3554,edad 30
06260,Esteban Echeverría,32,1717,1779,3496,edad 30
06260,Esteban Echeverría,33,1613,1679,3292,edad 30
06260,Esteban Echeverría,34,1582,1545,3127,edad 30
06260,Esteban Echeverría,35,1506,1722,3228,edad 30
06260,Esteban Echeverría,36,1574,1640,3214,edad 30
06260,Esteban Echeverría,37,1560,1610,3170,edad 30
06260,Esteban Echeverría,38,1608,1636,3244,edad 30
06260,Esteban Echeverría,39,1516,1530,3046,edad 30
06260,Esteban Echeverría,40,1545,1677,3222,edad 40
06260,Esteban Echeverría,41,1502,1483,2985,edad 40
06260,Esteban Echeverría,42,1526,1567,3093,edad 40
06260,Esteban Echeverría,43,1436,1454,2890,edad 40
06260,Esteban Echeverría,44,1332,1318,2650,edad 40
06260,Esteban Echeverría,45,1370,1407,2777,edad 40
06260,Esteban Echeverría,46,1293,1443,2736,edad 40
06260,Esteban Echeverría,47,1287,1324,2611,edad 40
06260,Esteban Echeverría,48,1352,1246,2598,edad 40
06260,Esteban Echeverría,49,1187,1259,2446,edad 40
06260,Esteban Echeverría,50,1309,1370,2679,edad 50
06260,Esteban Echeverría,51,1168,1253,2421,edad 50
06260,Esteban Echeverría,52,1199,1198,2397,edad 50
06260,Esteban Echeverría,53,1135,1092,2227,edad 50
06260,Esteban Echeverría,54,1049,1052,2101,edad 50
06260,Esteban Echeverría,55,907,975,1882,edad 50
06260,Esteban Echeverría,56,1134,1003,2137,edad 50
06260,Esteban Echeverría,57,869,947,1816,edad 50
06260,Esteban Echeverría,58,823,822,1645,edad 50
06260,Esteban Echeverría,59,718,758,1476,edad 50
06260,Esteban Echeverría,60,771,848,1619,edad 60
06260,Esteban Echeverría,61,687,692,1379,edad 60
06260,Esteban Echeverría,62,640,702,1342,edad 60
06260,Esteban Echeverría,63,605,652,1257,edad 60
06260,Esteban Echeverría,64,532,641,1173,edad 60
06260,Esteban Echeverría,65,585,688,1273,edad 60
06260,Esteban Echeverría,66,490,562,1052,edad 60
06260,Esteban Echeverría,67,484,544,1028,edad 60
06260,Esteban Echeverría,68,467,616,1083,edad 60
06260,Esteban Echeverría,69,461,547,1008,edad 60
06260,Esteban Echeverría,70,471,604,1075,edad 70
06260,Esteban Echeverría,71,422,539,961,edad 70
06260,Esteban Echeverría,72,399,545,944,edad 70
06260,Esteban Echeverría,73,324,479,803,edad 70
06260,Esteban Echeverría,74,338,467,805,edad 70
06260,Esteban Echeverría,75,300,459,759,edad 70
06260,Esteban Echeverría,76,297,420,717,edad 70
06260,Esteban Echeverría,77,219,380,599,edad 70
06260,Esteban Echeverría,78,236,341,577,edad 70
06260,Esteban Echeverría,79,198,301,499,edad 70
06260,Esteban Echeverría,80,176,299,475,edad 80
06260,Esteban Echeverría,81,146,261,407,edad 80
06260,Esteban Echeverría,82,129,206,335,edad 80
06260,Esteban Echeverría,83,107,166,273,edad 80
06260,Esteban Echeverría,84,68,148,216,edad 80
06260,Esteban Echeverría,85,61,160,221,edad 80
06260,Esteban Echeverría,86,61,111,172,edad 80
06260,Esteban Echeverría,87,55,100,155,edad 80
06260,Esteban Echeverría,88,40,83,123,edad 80
06260,Esteban Echeverría,89,32,66,98,edad 80
06260,Esteban Echeverría,90,36,53,89,edad 90
06260,Esteban Echeverría,91,16,39,55,edad 90
06260,Esteban Echeverría,92,13,36,49,edad 90
06260,Esteban Echeverría,93,11,22,33,edad 90
06260,Esteban Echeverría,94,5,24,29,edad 90
06260,Esteban Echeverría,95,8,17,25,edad 90
06260,Esteban Echeverría,96,2,9,11,edad 90
06260,Esteban Echeverría,97,6,10,16,edad 90
06260,Esteban Echeverría,98,3,5,8,edad 90
06260,Esteban Echeverría,99,1,4,5,edad 90
06260,Esteban Echeverría,110,0,1,1,edad 110
06270,Ezeiza,0,1324,1356,2680,edad 0
06270,Ezeiza,1,1258,1148,2406,edad 0
06270,Ezeiza,2,1345,1449,2794,edad 0
06270,Ezeiza,3,1365,1302,2667,edad 0
06270,Ezeiza,4,1401,1356,2757,edad 0
06270,Ezeiza,5,1425,1376,2801,edad 0
06270,Ezeiza,6,1343,1347,2690,edad 0
06270,Ezeiza,7,1317,1358,2675,edad 0
06270,Ezeiza,8,1333,1291,2624,edad 0
06270,Ezeiza,9,1303,1272,2575,edad 0
06270,Ezeiza,10,1376,1293,2669,edad 10
06270,Ezeiza,11,1329,1259,2588,edad 10
06270,Ezeiza,12,1309,1194,2503,edad 10
06270,Ezeiza,13,1223,1182,2405,edad 10
06270,Ezeiza,14,1196,1204,2400,edad 10
06270,Ezeiza,15,1101,1150,2251,edad 10
06270,Ezeiza,16,1056,1054,2110,edad 10
06270,Ezeiza,17,1039,1023,2062,edad 10
06270,Ezeiza,18,1126,1041,2167,edad 10
06270,Ezeiza,19,1209,1103,2312,edad 10
06270,Ezeiza,20,1188,1093,2281,edad 20
06270,Ezeiza,21,1153,1120,2273,edad 20
06270,Ezeiza,22,1068,1091,2159,edad 20
06270,Ezeiza,23,1098,1004,2102,edad 20
06270,Ezeiza,24,1061,1099,2160,edad 20
06270,Ezeiza,25,930,1020,1950,edad 20
06270,Ezeiza,26,874,958,1832,edad 20
06270,Ezeiza,27,989,970,1959,edad 20
06270,Ezeiza,28,974,932,1906,edad 20
06270,Ezeiza,29,905,851,1756,edad 20
06270,Ezeiza,30,968,990,1958,edad 30
06270,Ezeiza,31,885,854,1739,edad 30
06270,Ezeiza,32,885,843,1728,edad 30
06270,Ezeiza,33,805,803,1608,edad 30
06270,Ezeiza,34,731,784,1515,edad 30
06270,Ezeiza,35,788,798,1586,edad 30
06270,Ezeiza,36,806,781,1587,edad 30
06270,Ezeiza,37,790,743,1533,edad 30
06270,Ezeiza,38,818,790,1608,edad 30
06270,Ezeiza,39,685,758,1443,edad 30
06270,Ezeiza,40,776,778,1554,edad 40
06270,Ezeiza,41,746,712,1458,edad 40
06270,Ezeiza,42,787,744,1531,edad 40
06270,Ezeiza,43,703,738,1441,edad 40
06270,Ezeiza,44,621,666,1287,edad 40
06270,Ezeiza,45,701,637,1338,edad 40
06270,Ezeiza,46,650,623,1273,edad 40
06270,Ezeiza,47,652,616,1268,edad 40
06270,Ezeiza,48,576,567,1143,edad 40
06270,Ezeiza,49,582,541,1123,edad 40
06270,Ezeiza,50,608,597,1205,edad 50
06270,Ezeiza,51,524,524,1048,edad 50
06270,Ezeiza,52,506,531,1037,edad 50
06270,Ezeiza,53,550,528,1078,edad 50
06270,Ezeiza,54,436,452,888,edad 50
06270,Ezeiza,55,424,372,796,edad 50
06270,Ezeiza,56,403,440,843,edad 50
06270,Ezeiza,57,383,373,756,edad 50
06270,Ezeiza,58,318,385,703,edad 50
06270,Ezeiza,59,304,276,580,edad 50
06270,Ezeiza,60,332,379,711,edad 60
06270,Ezeiza,61,299,269,568,edad 60
06270,Ezeiza,62,300,270,570,edad 60
06270,Ezeiza,63,297,294,591,edad 60
06270,Ezeiza,64,272,286,558,edad 60
06270,Ezeiza,65,231,301,532,edad 60
06270,Ezeiza,66,234,237,471,edad 60
06270,Ezeiza,67,203,246,449,edad 60
06270,Ezeiza,68,206,230,436,edad 60
06270,Ezeiza,69,194,220,414,edad 60
06270,Ezeiza,70,212,265,477,edad 70
06270,Ezeiza,71,162,233,395,edad 70
06270,Ezeiza,72,197,199,396,edad 70
06270,Ezeiza,73,164,202,366,edad 70
06270,Ezeiza,74,114,205,319,edad 70
06270,Ezeiza,75,128,178,306,edad 70
06270,Ezeiza,76,127,163,290,edad 70
06270,Ezeiza,77,85,137,222,edad 70
06270,Ezeiza,78,107,150,257,edad 70
06270,Ezeiza,79,95,124,219,edad 70
06270,Ezeiza,80,72,94,166,edad 80
06270,Ezeiza,81,43,89,132,edad 80
06270,Ezeiza,82,40,75,115,edad 80
06270,Ezeiza,83,34,86,120,edad 80
06270,Ezeiza,84,32,75,107,edad 80
06270,Ezeiza,85,18,50,68,edad 80
06270,Ezeiza,86,20,49,69,edad 80
06270,Ezeiza,87,21,59,80,edad 80
06270,Ezeiza,88,18,39,57,edad 80
06270,Ezeiza,89,20,24,44,edad 80
06270,Ezeiza,90,9,28,37,edad 90
06270,Ezeiza,91,5,16,21,edad 90
06270,Ezeiza,92,7,20,27,edad 90
06270,Ezeiza,93,5,11,16,edad 90
06270,Ezeiza,94,2,10,12,edad 90
06270,Ezeiza,95,1,6,7,edad 90
06270,Ezeiza,96,2,4,6,edad 90
06270,Ezeiza,97,0,3,3,edad 90
06270,Ezeiza,98,0,2,2,edad 90
06274,Florencio Varela,0,4061,3891,7952,edad 0
06274,Florencio Varela,1,3771,3693,7464,edad 0
06274,Florencio Varela,2,4317,4080,8397,edad 0
06274,Florencio Varela,3,4083,3974,8057,edad 0
06274,Florencio Varela,4,4201,3976,8177,edad 0
06274,Florencio Varela,5,4289,4283,8572,edad 0
06274,Florencio Varela,6,4159,4209,8368,edad 0
06274,Florencio Varela,7,4132,3893,8025,edad 0
06274,Florencio Varela,8,4085,3859,7944,edad 0
06274,Florencio Varela,9,4080,3953,8033,edad 0
06274,Florencio Varela,10,4123,4079,8202,edad 10
06274,Florencio Varela,11,3933,3815,7748,edad 10
06274,Florencio Varela,12,3846,3760,7606,edad 10
06274,Florencio Varela,13,3690,3623,7313,edad 10
06274,Florencio Varela,14,3555,3527,7082,edad 10
06274,Florencio Varela,15,3509,3394,6903,edad 10
06274,Florencio Varela,16,3323,3279,6602,edad 10
06274,Florencio Varela,17,3152,2983,6135,edad 10
06274,Florencio Varela,18,3190,3149,6339,edad 10
06274,Florencio Varela,19,3382,3556,6938,edad 10
06274,Florencio Varela,20,3360,3286,6646,edad 20
06274,Florencio Varela,21,3459,3409,6868,edad 20
06274,Florencio Varela,22,3365,3327,6692,edad 20
06274,Florencio Varela,23,3376,3277,6653,edad 20
06274,Florencio Varela,24,3205,3169,6374,edad 20
06274,Florencio Varela,25,3026,2902,5928,edad 20
06274,Florencio Varela,26,2946,2876,5822,edad 20
06274,Florencio Varela,27,2853,2855,5708,edad 20
06274,Florencio Varela,28,2843,2742,5585,edad 20
06274,Florencio Varela,29,2670,2719,5389,edad 20
06274,Florencio Varela,30,2982,3024,6006,edad 30
06274,Florencio Varela,31,2625,2504,5129,edad 30
06274,Florencio Varela,32,2591,2504,5095,edad 30
06274,Florencio Varela,33,2326,2263,4589,edad 30
06274,Florencio Varela,34,2207,2106,4313,edad 30
06274,Florencio Varela,35,2299,2274,4573,edad 30
06274,Florencio Varela,36,2220,2166,4386,edad 30
06274,Florencio Varela,37,2130,2078,4208,edad 30
06274,Florencio Varela,38,2103,2199,4302,edad 30
06274,Florencio Varela,39,1921,1928,3849,edad 30
06274,Florencio Varela,40,1988,2102,4090,edad 40
06274,Florencio Varela,41,2030,1839,3869,edad 40
06274,Florencio Varela,42,2049,2009,4058,edad 40
06274,Florencio Varela,43,1896,1845,3741,edad 40
06274,Florencio Varela,44,1685,1666,3351,edad 40
06274,Florencio Varela,45,1813,1821,3634,edad 40
06274,Florencio Varela,46,1685,1671,3356,edad 40
06274,Florencio Varela,47,1599,1650,3249,edad 40
06274,Florencio Varela,48,1620,1650,3270,edad 40
06274,Florencio Varela,49,1590,1563,3153,edad 40
06274,Florencio Varela,50,1644,1825,3469,edad 50
06274,Florencio Varela,51,1535,1546,3081,edad 50
06274,Florencio Varela,52,1549,1544,3093,edad 50
06274,Florencio Varela,53,1443,1473,2916,edad 50
06274,Florencio Varela,54,1346,1382,2728,edad 50
06274,Florencio Varela,55,1168,1203,2371,edad 50
06274,Florencio Varela,56,1407,1378,2785,edad 50
06274,Florencio Varela,57,1144,1151,2295,edad 50
06274,Florencio Varela,58,1060,1077,2137,edad 50
06274,Florencio Varela,59,1016,948,1964,edad 50
06274,Florencio Varela,60,1044,1069,2113,edad 60
06274,Florencio Varela,61,892,900,1792,edad 60
06274,Florencio Varela,62,887,895,1782,edad 60
06274,Florencio Varela,63,813,902,1715,edad 60
06274,Florencio Varela,64,785,817,1602,edad 60
06274,Florencio Varela,65,833,842,1675,edad 60
06274,Florencio Varela,66,665,752,1417,edad 60
06274,Florencio Varela,67,625,669,1294,edad 60
06274,Florencio Varela,68,587,647,1234,edad 60
06274,Florencio Varela,69,550,586,1136,edad 60
06274,Florencio Varela,70,558,701,1259,edad 70
06274,Florencio Varela,71,480,553,1033,edad 70
06274,Florencio Varela,72,445,549,994,edad 70
06274,Florencio Varela,73,363,517,880,edad 70
06274,Florencio Varela,74,350,460,810,edad 70
06274,Florencio Varela,75,327,427,754,edad 70
06274,Florencio Varela,76,283,413,696,edad 70
06274,Florencio Varela,77,212,360,572,edad 70
06274,Florencio Varela,78,249,354,603,edad 70
06274,Florencio Varela,79,190,282,472,edad 70
06274,Florencio Varela,80,157,268,425,edad 80
06274,Florencio Varela,81,119,238,357,edad 80
06274,Florencio Varela,82,100,198,298,edad 80
06274,Florencio Varela,83,79,182,261,edad 80
06274,Florencio Varela,84,64,159,223,edad 80
06274,Florencio Varela,85,58,123,181,edad 80
06274,Florencio Varela,86,44,126,170,edad 80
06274,Florencio Varela,87,41,99,140,edad 80
06274,Florencio Varela,88,34,82,116,edad 80
06274,Florencio Varela,89,19,55,74,edad 80
06274,Florencio Varela,90,27,51,78,edad 90
06274,Florencio Varela,91,15,37,52,edad 90
06274,Florencio Varela,92,7,42,49,edad 90
06274,Florencio Varela,93,9,31,40,edad 90
06274,Florencio Varela,94,8,20,28,edad 90
06274,Florencio Varela,95,5,10,15,edad 90
06274,Florencio Varela,96,8,9,17,edad 90
06274,Florencio Varela,97,0,9,9,edad 90
06274,Florencio Varela,98,1,7,8,edad 90
06274,Florencio Varela,99,1,6,7,edad 90
06371,General San Martín,0,3234,3064,6298,edad 0
06371,General San Martín,1,2819,2737,5556,edad 0
06371,General San Martín,2,3214,3103,6317,edad 0
06371,General San Martín,3,3028,2908,5936,edad 0
06371,General San Martín,4,3171,3022,6193,edad 0
06371,General San Martín,5,3202,3130,6332,edad 0
06371,General San Martín,6,3080,3144,6224,edad 0
06371,General San Martín,7,3185,2992,6177,edad 0
06371,General San Martín,8,3154,2980,6134,edad 0
06371,General San Martín,9,3131,2973,6104,edad 0
06371,General San Martín,10,3272,3300,6572,edad 10
06371,General San Martín,11,3374,3156,6530,edad 10
06371,General San Martín,12,3386,3141,6527,edad 10
06371,General San Martín,13,3252,3164,6416,edad 10
06371,General San Martín,14,3221,3061,6282,edad 10
06371,General San Martín,15,3161,3145,6306,edad 10
06371,General San Martín,16,3010,3019,6029,edad 10
06371,General San Martín,17,3079,2999,6078,edad 10
06371,General San Martín,18,3147,3082,6229,edad 10
06371,General San Martín,19,3293,3353,6646,edad 10
06371,General San Martín,20,3395,3352,6747,edad 20
06371,General San Martín,21,3567,3598,7165,edad 20
06371,General San Martín,22,3467,3533,7000,edad 20
06371,General San Martín,23,3423,3484,6907,edad 20
06371,General San Martín,24,3370,3469,6839,edad 20
06371,General San Martín,25,3296,3321,6617,edad 20
06371,General San Martín,26,3174,3248,6422,edad 20
06371,General San Martín,27,3011,3065,6076,edad 20
06371,General San Martín,28,2946,3037,5983,edad 20
06371,General San Martín,29,2853,2879,5732,edad 20
06371,General San Martín,30,3033,3036,6069,edad 30
06371,General San Martín,31,2737,2763,5500,edad 30
06371,General San Martín,32,2691,2746,5437,edad 30
06371,General San Martín,33,2618,2612,5230,edad 30
06371,General San Martín,34,2441,2516,4957,edad 30
06371,General San Martín,35,2486,2581,5067,edad 30
06371,General San Martín,36,2459,2563,5022,edad 30
06371,General San Martín,37,2359,2485,4844,edad 30
06371,General San Martín,38,2527,2629,5156,edad 30
06371,General San Martín,39,2355,2546,4901,edad 30
06371,General San Martín,40,2407,2674,5081,edad 40
06371,General San Martín,41,2485,2489,4974,edad 40
06371,General San Martín,42,2491,2679,5170,edad 40
06371,General San Martín,43,2479,2545,5024,edad 40
06371,General San Martín,44,2237,2435,4672,edad 40
06371,General San Martín,45,2361,2528,4889,edad 40
06371,General San Martín,46,2260,2486,4746,edad 40
06371,General San Martín,47,2281,2403,4684,edad 40
06371,General San Martín,48,2284,2508,4792,edad 40
06371,General San Martín,49,2098,2450,4548,edad 40
06371,General San Martín,50,2262,2758,5020,edad 50
06371,General San Martín,51,2200,2402,4602,edad 50
06371,General San Martín,52,2156,2461,4617,edad 50
06371,General San Martín,53,2178,2263,4441,edad 50
06371,General San Martín,54,1968,2308,4276,edad 50
06371,General San Martín,55,1980,2232,4212,edad 50
06371,General San Martín,56,1952,2324,4276,edad 50
06371,General San Martín,57,1779,2134,3913,edad 50
06371,General San Martín,58,1751,1895,3646,edad 50
06371,General San Martín,59,1563,1863,3426,edad 50
06371,General San Martín,60,1660,2092,3752,edad 60
06371,General San Martín,61,1556,1876,3432,edad 60
06371,General San Martín,62,1614,1909,3523,edad 60
06371,General San Martín,63,1542,1885,3427,edad 60
06371,General San Martín,64,1500,1822,3322,edad 60
06371,General San Martín,65,1567,1996,3563,edad 60
06371,General San Martín,66,1300,1742,3042,edad 60
06371,General San Martín,67,1337,1718,3055,edad 60
06371,General San Martín,68,1315,1780,3095,edad 60
06371,General San Martín,69,1315,1682,2997,edad 60
06371,General San Martín,70,1395,1894,3289,edad 70
06371,General San Martín,71,1180,1693,2873,edad 70
06371,General San Martín,72,1148,1724,2872,edad 70
06371,General San Martín,73,1145,1682,2827,edad 70
06371,General San Martín,74,1066,1643,2709,edad 70
06371,General San Martín,75,1030,1600,2630,edad 70
06371,General San Martín,76,932,1471,2403,edad 70
06371,General San Martín,77,820,1371,2191,edad 70
06371,General San Martín,78,845,1318,2163,edad 70
06371,General San Martín,79,646,1107,1753,edad 70
06371,General San Martín,80,632,1127,1759,edad 80
06371,General San Martín,81,533,914,1447,edad 80
06371,General San Martín,82,380,770,1150,edad 80
06371,General San Martín,83,311,673,984,edad 80
06371,General San Martín,84,268,627,895,edad 80
06371,General San Martín,85,260,575,835,edad 80
06371,General San Martín,86,214,535,749,edad 80
06371,General San Martín,87,171,447,618,edad 80
06371,General San Martín,88,168,336,504,edad 80
06371,General San Martín,89,115,287,402,edad 80
06371,General San Martín,90,93,267,360,edad 90
06371,General San Martín,91,60,180,240,edad 90
06371,General San Martín,92,56,146,202,edad 90
06371,General San Martín,93,40,117,157,edad 90
06371,General San Martín,94,26,70,96,edad 90
06371,General San Martín,95,16,50,66,edad 90
06371,General San Martín,96,9,42,51,edad 90
06371,General San Martín,97,11,31,42,edad 90
06371,General San Martín,98,7,22,29,edad 90
06371,General San Martín,99,8,16,24,edad 90
06408,Hurlingham,0,1335,1384,2719,edad 0
06408,Hurlingham,1,1253,1260,2513,edad 0
06408,Hurlingham,2,1425,1327,2752,edad 0
06408,Hurlingham,3,1374,1402,2776,edad 0
06408,Hurlingham,4,1393,1361,2754,edad 0
06408,Hurlingham,5,1413,1388,2801,edad 0
06408,Hurlingham,6,1424,1446,2870,edad 0
06408,Hurlingham,7,1387,1365,2752,edad 0
06408,Hurlingham,8,1415,1368,2783,edad 0
06408,Hurlingham,9,1406,1449,2855,edad 0
06408,Hurlingham,10,1551,1450,3001,edad 10
06408,Hurlingham,11,1562,1484,3046,edad 10
06408,Hurlingham,12,1439,1457,2896,edad 10
06408,Hurlingham,13,1568,1460,3028,edad 10
06408,Hurlingham,14,1555,1428,2983,edad 10
06408,Hurlingham,15,1460,1451,2911,edad 10
06408,Hurlingham,16,1492,1383,2875,edad 10
06408,Hurlingham,17,1410,1371,2781,edad 10
06408,Hurlingham,18,1475,1345,2820,edad 10
06408,Hurlingham,19,1559,1584,3143,edad 10
06408,Hurlingham,20,1471,1484,2955,edad 20
06408,Hurlingham,21,1574,1598,3172,edad 20
06408,Hurlingham,22,1558,1582,3140,edad 20
06408,Hurlingham,23,1483,1550,3033,edad 20
06408,Hurlingham,24,1520,1564,3084,edad 20
06408,Hurlingham,25,1344,1473,2817,edad 20
06408,Hurlingham,26,1361,1401,2762,edad 20
06408,Hurlingham,27,1310,1304,2614,edad 20
06408,Hurlingham,28,1306,1252,2558,edad 20
06408,Hurlingham,29,1273,1258,2531,edad 20
06408,Hurlingham,30,1283,1317,2600,edad 30
06408,Hurlingham,31,1191,1184,2375,edad 30
06408,Hurlingham,32,1105,1101,2206,edad 30
06408,Hurlingham,33,1145,1063,2208,edad 30
06408,Hurlingham,34,1089,1050,2139,edad 30
06408,Hurlingham,35,1036,1086,2122,edad 30
06408,Hurlingham,36,1048,1097,2145,edad 30
06408,Hurlingham,37,1051,1123,2174,edad 30
06408,Hurlingham,38,1069,1171,2240,edad 30
06408,Hurlingham,39,1012,1071,2083,edad 30
06408,Hurlingham,40,1049,1163,2212,edad 40
06408,Hurlingham,41,1043,1076,2119,edad 40
06408,Hurlingham,42,1080,1144,2224,edad 40
06408,Hurlingham,43,1009,1091,2100,edad 40
06408,Hurlingham,44,911,1000,1911,edad 40
06408,Hurlingham,45,970,1128,2098,edad 40
06408,Hurlingham,46,1037,1113,2150,edad 40
06408,Hurlingham,47,982,1120,2102,edad 40
06408,Hurlingham,48,987,1113,2100,edad 40
06408,Hurlingham,49,903,967,1870,edad 40
06408,Hurlingham,50,1001,1165,2166,edad 50
06408,Hurlingham,51,947,1014,1961,edad 50
06408,Hurlingham,52,937,1081,2018,edad 50
06408,Hurlingham,53,933,1038,1971,edad 50
06408,Hurlingham,54,875,962,1837,edad 50
06408,Hurlingham,55,846,865,1711,edad 50
06408,Hurlingham,56,898,935,1833,edad 50
06408,Hurlingham,57,737,861,1598,edad 50
06408,Hurlingham,58,769,768,1537,edad 50
06408,Hurlingham,59,679,737,1416,edad 50
06408,Hurlingham,60,667,849,1516,edad 60
06408,Hurlingham,61,597,733,1330,edad 60
06408,Hurlingham,62,680,794,1474,edad 60
06408,Hurlingham,63,635,693,1328,edad 60
06408,Hurlingham,64,611,670,1281,edad 60
06408,Hurlingham,65,621,698,1319,edad 60
06408,Hurlingham,66,555,738,1293,edad 60
06408,Hurlingham,67,526,631,1157,edad 60
06408,Hurlingham,68,519,639,1158,edad 60
06408,Hurlingham,69,503,631,1134,edad 60
06408,Hurlingham,70,523,697,1220,edad 70
06408,Hurlingham,71,469,668,1137,edad 70
06408,Hurlingham,72,445,624,1069,edad 70
06408,Hurlingham,73,444,569,1013,edad 70
06408,Hurlingham,74,382,592,974,edad 70
06408,Hurlingham,75,357,507,864,edad 70
06408,Hurlingham,76,328,524,852,edad 70
06408,Hurlingham,77,286,403,689,edad 70
06408,Hurlingham,78,302,462,764,edad 70
06408,Hurlingham,79,214,343,557,edad 70
06408,Hurlingham,80,207,368,575,edad 80
06408,Hurlingham,81,145,289,434,edad 80
06408,Hurlingham,82,129,244,373,edad 80
06408,Hurlingham,83,111,221,332,edad 80
06408,Hurlingham,84,87,144,231,edad 80
06408,Hurlingham,85,63,148,211,edad 80
06408,Hurlingham,86,72,145,217,edad 80
06408,Hurlingham,87,42,148,190,edad 80
06408,Hurlingham,88,33,103,136,edad 80
06408,Hurlingham,89,33,90,123,edad 80
06408,Hurlingham,90,15,76,91,edad 90
06408,Hurlingham,91,18,53,71,edad 90
06408,Hurlingham,92,14,35,49,edad 90
06408,Hurlingham,93,8,41,49,edad 90
06408,Hurlingham,94,7,15,22,edad 90
06408,Hurlingham,95,5,14,19,edad 90
06408,Hurlingham,96,1,12,13,edad 90
06408,Hurlingham,97,6,9,15,edad 90
06408,Hurlingham,98,3,4,7,edad 90
06408,Hurlingham,99,1,2,3,edad 90
06410,Ituzaingó,0,1254,1145,2399,edad 0
06410,Ituzaingó,1,1047,1075,2122,edad 0
06410,Ituzaingó,2,1198,1182,2380,edad 0
06410,Ituzaingó,3,1244,1157,2401,edad 0
06410,Ituzaingó,4,1255,1204,2459,edad 0
06410,Ituzaingó,5,1285,1276,2561,edad 0
06410,Ituzaingó,6,1293,1299,2592,edad 0
06410,Ituzaingó,7,1281,1224,2505,edad 0
06410,Ituzaingó,8,1334,1232,2566,edad 0
06410,Ituzaingó,9,1277,1339,2616,edad 0
06410,Ituzaingó,10,1416,1338,2754,edad 10
06410,Ituzaingó,11,1436,1380,2816,edad 10
06410,Ituzaingó,12,1326,1261,2587,edad 10
06410,Ituzaingó,13,1381,1299,2680,edad 10
06410,Ituzaingó,14,1392,1315,2707,edad 10
06410,Ituzaingó,15,1392,1335,2727,edad 10
06410,Ituzaingó,16,1349,1237,2586,edad 10
06410,Ituzaingó,17,1300,1295,2595,edad 10
06410,Ituzaingó,18,1323,1292,2615,edad 10
06410,Ituzaingó,19,1306,1326,2632,edad 10
06410,Ituzaingó,20,1286,1346,2632,edad 20
06410,Ituzaingó,21,1460,1387,2847,edad 20
06410,Ituzaingó,22,1401,1312,2713,edad 20
06410,Ituzaingó,23,1434,1331,2765,edad 20
06410,Ituzaingó,24,1301,1239,2540,edad 20
06410,Ituzaingó,25,1216,1257,2473,edad 20
06410,Ituzaingó,26,1169,1259,2428,edad 20
06410,Ituzaingó,27,1086,1120,2206,edad 20
06410,Ituzaingó,28,1109,1124,2233,edad 20
06410,Ituzaingó,29,1084,1172,2256,edad 20
06410,Ituzaingó,30,1150,1269,2419,edad 30
06410,Ituzaingó,31,1123,1170,2293,edad 30
06410,Ituzaingó,32,1007,1116,2123,edad 30
06410,Ituzaingó,33,1031,1076,2107,edad 30
06410,Ituzaingó,34,979,998,1977,edad 30
06410,Ituzaingó,35,1014,1029,2043,edad 30
06410,Ituzaingó,36,1009,1029,2038,edad 30
06410,Ituzaingó,37,922,1031,1953,edad 30
06410,Ituzaingó,38,1031,1081,2112,edad 30
06410,Ituzaingó,39,961,1063,2024,edad 30
06410,Ituzaingó,40,1017,1139,2156,edad 40
06410,Ituzaingó,41,984,1016,2000,edad 40
06410,Ituzaingó,42,980,1166,2146,edad 40
06410,Ituzaingó,43,937,1039,1976,edad 40
06410,Ituzaingó,44,916,960,1876,edad 40
06410,Ituzaingó,45,908,963,1871,edad 40
06410,Ituzaingó,46,868,1027,1895,edad 40
06410,Ituzaingó,47,882,1000,1882,edad 40
06410,Ituzaingó,48,915,994,1909,edad 40
06410,Ituzaingó,49,892,968,1860,edad 40
06410,Ituzaingó,50,983,1071,2054,edad 50
06410,Ituzaingó,51,896,998,1894,edad 50
06410,Ituzaingó,52,880,973,1853,edad 50
06410,Ituzaingó,53,895,873,1768,edad 50
06410,Ituzaingó,54,866,920,1786,edad 50
06410,Ituzaingó,55,753,874,1627,edad 50
06410,Ituzaingó,56,818,910,1728,edad 50
06410,Ituzaingó,57,699,787,1486,edad 50
06410,Ituzaingó,58,681,780,1461,edad 50
06410,Ituzaingó,59,565,644,1209,edad 50
06410,Ituzaingó,60,638,753,1391,edad 60
06410,Ituzaingó,61,602,661,1263,edad 60
06410,Ituzaingó,62,589,638,1227,edad 60
06410,Ituzaingó,63,555,618,1173,edad 60
06410,Ituzaingó,64,562,610,1172,edad 60
06410,Ituzaingó,65,524,701,1225,edad 60
06410,Ituzaingó,66,521,636,1157,edad 60
06410,Ituzaingó,67,510,600,1110,edad 60
06410,Ituzaingó,68,507,584,1091,edad 60
06410,Ituzaingó,69,455,571,1026,edad 60
06410,Ituzaingó,70,499,660,1159,edad 70
06410,Ituzaingó,71,475,583,1058,edad 70
06410,Ituzaingó,72,437,594,1031,edad 70
06410,Ituzaingó,73,375,621,996,edad 70
06410,Ituzaingó,74,359,539,898,edad 70
06410,Ituzaingó,75,332,543,875,edad 70
06410,Ituzaingó,76,305,466,771,edad 70
06410,Ituzaingó,77,272,398,670,edad 70
06410,Ituzaingó,78,253,427,680,edad 70
06410,Ituzaingó,79,236,347,583,edad 70
06410,Ituzaingó,80,194,406,600,edad 80
06410,Ituzaingó,81,152,290,442,edad 80
06410,Ituzaingó,82,117,289,406,edad 80
06410,Ituzaingó,83,119,224,343,edad 80
06410,Ituzaingó,84,82,239,321,edad 80
06410,Ituzaingó,85,89,182,271,edad 80
06410,Ituzaingó,86,77,170,247,edad 80
06410,Ituzaingó,87,52,178,230,edad 80
06410,Ituzaingó,88,46,134,180,edad 80
06410,Ituzaingó,89,27,111,138,edad 80
06410,Ituzaingó,90,29,90,119,edad 90
06410,Ituzaingó,91,18,80,98,edad 90
06410,Ituzaingó,92,17,59,76,edad 90
06410,Ituzaingó,93,10,33,43,edad 90
06410,Ituzaingó,94,5,39,44,edad 90
06410,Ituzaingó,95,4,26,30,edad 90
06410,Ituzaingó,96,5,18,23,edad 90
06410,Ituzaingó,97,3,10,13,edad 90
06410,Ituzaingó,98,1,5,6,edad 90
06410,Ituzaingó,99,4,8,12,edad 90
06412,José C. Paz,0,2594,2542,5136,edad 0
06412,José C. Paz,1,2362,2236,4598,edad 0
06412,José C. Paz,2,2650,2539,5189,edad 0
06412,José C. Paz,3,2532,2456,4988,edad 0
06412,José C. Paz,4,2563,2447,5010,edad 0
06412,José C. Paz,5,2655,2550,5205,edad 0
06412,José C. Paz,6,2610,2569,5179,edad 0
06412,José C. Paz,7,2538,2412,4950,edad 0
06412,José C. Paz,8,2470,2442,4912,edad 0
06412,José C. Paz,9,2490,2393,4883,edad 0
06412,José C. Paz,10,2656,2533,5189,edad 10
06412,José C. Paz,11,2507,2532,5039,edad 10
06412,José C. Paz,12,2400,2416,4816,edad 10
06412,José C. Paz,13,2363,2316,4679,edad 10
06412,José C. Paz,14,2322,2379,4701,edad 10
06412,José C. Paz,15,2326,2232,4558,edad 10
06412,José C. Paz,16,2226,2080,4306,edad 10
06412,José C. Paz,17,2184,2114,4298,edad 10
06412,José C. Paz,18,2148,2128,4276,edad 10
06412,José C. Paz,19,2250,2295,4545,edad 10
06412,José C. Paz,20,2224,2267,4491,edad 20
06412,José C. Paz,21,2310,2256,4566,edad 20
06412,José C. Paz,22,2228,2244,4472,edad 20
06412,José C. Paz,23,2120,2171,4291,edad 20
06412,José C. Paz,24,2068,2006,4074,edad 20
06412,José C. Paz,25,1850,1863,3713,edad 20
06412,José C. Paz,26,1708,1825,3533,edad 20
06412,José C. Paz,27,1774,1784,3558,edad 20
06412,José C. Paz,28,1808,1731,3539,edad 20
06412,José C. Paz,29,1651,1650,3301,edad 20
06412,José C. Paz,30,1802,1800,3602,edad 30
06412,José C. Paz,31,1614,1640,3254,edad 30
06412,José C. Paz,32,1660,1539,3199,edad 30
06412,José C. Paz,33,1489,1459,2948,edad 30
06412,José C. Paz,34,1412,1317,2729,edad 30
06412,José C. Paz,35,1316,1445,2761,edad 30
06412,José C. Paz,36,1374,1395,2769,edad 30
06412,José C. Paz,37,1280,1383,2663,edad 30
06412,José C. Paz,38,1394,1482,2876,edad 30
06412,José C. Paz,39,1257,1352,2609,edad 30
06412,José C. Paz,40,1324,1423,2747,edad 40
06412,José C. Paz,41,1331,1343,2674,edad 40
06412,José C. Paz,42,1384,1490,2874,edad 40
06412,José C. Paz,43,1342,1347,2689,edad 40
06412,José C. Paz,44,1207,1243,2450,edad 40
06412,José C. Paz,45,1232,1280,2512,edad 40
06412,José C. Paz,46,1224,1221,2445,edad 40
06412,José C. Paz,47,1196,1224,2420,edad 40
06412,José C. Paz,48,1254,1233,2487,edad 40
06412,José C. Paz,49,1199,1140,2339,edad 40
06412,José C. Paz,50,1172,1229,2401,edad 50
06412,José C. Paz,51,1129,1079,2208,edad 50
06412,José C. Paz,52,1029,1088,2117,edad 50
06412,José C. Paz,53,1028,1112,2140,edad 50
06412,José C. Paz,54,935,986,1921,edad 50
06412,José C. Paz,55,827,903,1730,edad 50
06412,José C. Paz,56,943,985,1928,edad 50
06412,José C. Paz,57,780,800,1580,edad 50
06412,José C. Paz,58,750,706,1456,edad 50
06412,José C. Paz,59,668,676,1344,edad 50
06412,José C. Paz,60,674,743,1417,edad 60
06412,José C. Paz,61,683,662,1345,edad 60
06412,José C. Paz,62,611,659,1270,edad 60
06412,José C. Paz,63,593,648,1241,edad 60
06412,José C. Paz,64,561,606,1167,edad 60
06412,José C. Paz,65,573,601,1174,edad 60
06412,José C. Paz,66,454,587,1041,edad 60
06412,José C. Paz,67,458,522,980,edad 60
06412,José C. Paz,68,448,519,967,edad 60
06412,José C. Paz,69,431,523,954,edad 60
06412,José C. Paz,70,389,525,914,edad 70
06412,José C. Paz,71,379,477,856,edad 70
06412,José C. Paz,72,337,475,812,edad 70
06412,José C. Paz,73,309,405,714,edad 70
06412,José C. Paz,74,294,365,659,edad 70
06412,José C. Paz,75,299,393,692,edad 70
06412,José C. Paz,76,239,352,591,edad 70
06412,José C. Paz,77,206,259,465,edad 70
06412,José C. Paz,78,199,322,521,edad 70
06412,José C. Paz,79,166,233,399,edad 70
06412,José C. Paz,80,129,218,347,edad 80
06412,José C. Paz,81,96,204,300,edad 80
06412,José C. Paz,82,98,172,270,edad 80
06412,José C. Paz,83,70,143,213,edad 80
06412,José C. Paz,84,44,131,175,edad 80
06412,José C. Paz,85,58,104,162,edad 80
06412,José C. Paz,86,44,89,133,edad 80
06412,José C. Paz,87,38,84,122,edad 80
06412,José C. Paz,88,30,69,99,edad 80
06412,José C. Paz,89,33,64,97,edad 80
06412,José C. Paz,90,15,47,62,edad 90
06412,José C. Paz,91,13,38,51,edad 90
06412,José C. Paz,92,4,33,37,edad 90
06412,José C. Paz,93,4,17,21,edad 90
06412,José C. Paz,94,4,16,20,edad 90
06412,José C. Paz,95,4,12,16,edad 90
06412,José C. Paz,96,3,7,10,edad 90
06412,José C. Paz,97,2,9,11,edad 90
06412,José C. Paz,98,1,6,7,edad 90
06412,José C. Paz,99,1,4,5,edad 90
06427,La Matanza,0,12079,11735,23814,edad 0
06427,La Matanza,1,11072,10628,21700,edad 0
06427,La Matanza,2,12437,11783,24220,edad 0
06427,La Matanza,3,11578,11166,22744,edad 0
06427,La Matanza,4,11962,11466,23428,edad 0
06427,La Matanza,5,12524,12504,25028,edad 0
06427,La Matanza,6,12281,11912,24193,edad 0
06427,La Matanza,7,11886,11567,23453,edad 0
06427,La Matanza,8,12012,11604,23616,edad 0
06427,La Matanza,9,11797,11596,23393,edad 0
06427,La Matanza,10,12692,12189,24881,edad 10
06427,La Matanza,11,12042,11746,23788,edad 10
06427,La Matanza,12,11795,11609,23404,edad 10
06427,La Matanza,13,11647,11329,22976,edad 10
06427,La Matanza,14,11532,11246,22778,edad 10
06427,La Matanza,15,11027,11159,22186,edad 10
06427,La Matanza,16,10567,10526,21093,edad 10
06427,La Matanza,17,10245,10299,20544,edad 10
06427,La Matanza,18,10714,10422,21136,edad 10
06427,La Matanza,19,11065,11457,22522,edad 10
06427,La Matanza,20,11230,11313,22543,edad 20
06427,La Matanza,21,11679,11672,23351,edad 20
06427,La Matanza,22,11316,11713,23029,edad 20
06427,La Matanza,23,11535,11633,23168,edad 20
06427,La Matanza,24,11271,11694,22965,edad 20
06427,La Matanza,25,10486,10657,21143,edad 20
06427,La Matanza,26,10374,10661,21035,edad 20
06427,La Matanza,27,9857,10100,19957,edad 20
06427,La Matanza,28,9885,9788,19673,edad 20
06427,La Matanza,29,9456,9659,19115,edad 20
06427,La Matanza,30,10047,10475,20522,edad 30
06427,La Matanza,31,9117,9217,18334,edad 30
06427,La Matanza,32,8903,9309,18212,edad 30
06427,La Matanza,33,8488,8666,17154,edad 30
06427,La Matanza,34,7883,8049,15932,edad 30
06427,La Matanza,35,8146,8231,16377,edad 30
06427,La Matanza,36,8002,8313,16315,edad 30
06427,La Matanza,37,7613,7967,15580,edad 30
06427,La Matanza,38,8005,8410,16415,edad 30
06427,La Matanza,39,7579,7551,15130,edad 30
06427,La Matanza,40,7640,7952,15592,edad 40
06427,La Matanza,41,7463,7437,14900,edad 40
06427,La Matanza,42,7529,7787,15316,edad 40
06427,La Matanza,43,7364,7370,14734,edad 40
06427,La Matanza,44,6477,7100,13577,edad 40
06427,La Matanza,45,6896,7439,14335,edad 40
06427,La Matanza,46,6566,7122,13688,edad 40
06427,La Matanza,47,6419,6979,13398,edad 40
06427,La Matanza,48,6349,6972,13321,edad 40
06427,La Matanza,49,6214,6443,12657,edad 40
06427,La Matanza,50,6680,7636,14316,edad 50
06427,La Matanza,51,6269,6572,12841,edad 50
06427,La Matanza,52,6486,6719,13205,edad 50
06427,La Matanza,53,6097,6689,12786,edad 50
06427,La Matanza,54,5759,6134,11893,edad 50
06427,La Matanza,55,5216,5684,10900,edad 50
06427,La Matanza,56,5722,6077,11799,edad 50
06427,La Matanza,57,4919,5393,10312,edad 50
06427,La Matanza,58,4725,5111,9836,edad 50
06427,La Matanza,59,4222,4731,8953,edad 50
06427,La Matanza,60,4465,5224,9689,edad 60
06427,La Matanza,61,4137,4635,8772,edad 60
06427,La Matanza,62,4133,4750,8883,edad 60
06427,La Matanza,63,3900,4360,8260,edad 60
06427,La Matanza,64,3617,4290,7907,edad 60
06427,La Matanza,65,3761,4522,8283,edad 60
06427,La Matanza,66,3256,4043,7299,edad 60
06427,La Matanza,67,3209,3785,6994,edad 60
06427,La Matanza,68,3139,3954,7093,edad 60
06427,La Matanza,69,2996,3719,6715,edad 60
06427,La Matanza,70,2998,4000,6998,edad 70
06427,La Matanza,71,2802,3641,6443,edad 70
06427,La Matanza,72,2610,3456,6066,edad 70
06427,La Matanza,73,2366,3343,5709,edad 70
06427,La Matanza,74,2205,3222,5427,edad 70
06427,La Matanza,75,2043,3083,5126,edad 70
06427,La Matanza,76,1913,2811,4724,edad 70
06427,La Matanza,77,1693,2440,4133,edad 70
06427,La Matanza,78,1558,2419,3977,edad 70
06427,La Matanza,79,1270,2052,3322,edad 70
06427,La Matanza,80,1139,1945,3084,edad 80
06427,La Matanza,81,925,1530,2455,edad 80
06427,La Matanza,82,746,1480,2226,edad 80
06427,La Matanza,83,597,1137,1734,edad 80
06427,La Matanza,84,489,1017,1506,edad 80
06427,La Matanza,85,436,891,1327,edad 80
06427,La Matanza,86,366,851,1217,edad 80
06427,La Matanza,87,318,776,1094,edad 80
06427,La Matanza,88,266,608,874,edad 80
06427,La Matanza,89,221,449,670,edad 80
06427,La Matanza,90,152,439,591,edad 90
06427,La Matanza,91,104,277,381,edad 90
06427,La Matanza,92,86,219,305,edad 90
06427,La Matanza,93,70,154,224,edad 90
06427,La Matanza,94,43,124,167,edad 90
06427,La Matanza,95,31,88,119,edad 90
06427,La Matanza,96,28,84,112,edad 90
06427,La Matanza,97,8,49,57,edad 90
06427,La Matanza,98,8,34,42,edad 90
06427,La Matanza,99,18,33,51,edad 90
06434,Lanús,0,3382,3202,6584,edad 0
06434,Lanús,1,3021,2949,5970,edad 0
06434,Lanús,2,3286,3249,6535,edad 0
06434,Lanús,3,3241,3174,6415,edad 0
06434,Lanús,4,3269,3180,6449,edad 0
06434,Lanús,5,3467,3237,6704,edad 0
06434,Lanús,6,3328,3298,6626,edad 0
06434,Lanús,7,3245,3228,6473,edad 0
06434,Lanús,8,3338,3103,6441,edad 0
06434,Lanús,9,3410,3431,6841,edad 0
06434,Lanús,10,3541,3570,7111,edad 10
06434,Lanús,11,3560,3537,7097,edad 10
06434,Lanús,12,3470,3493,6963,edad 10
06434,Lanús,13,3468,3546,7014,edad 10
06434,Lanús,14,3602,3499,7101,edad 10
06434,Lanús,15,3538,3562,7100,edad 10
06434,Lanús,16,3464,3477,6941,edad 10
06434,Lanús,17,3439,3268,6707,edad 10
06434,Lanús,18,3679,3362,7041,edad 10
06434,Lanús,19,3679,3877,7556,edad 10
06434,Lanús,20,3768,3760,7528,edad 20
06434,Lanús,21,3885,4025,7910,edad 20
06434,Lanús,22,3866,3825,7691,edad 20
06434,Lanús,23,3897,4005,7902,edad 20
06434,Lanús,24,3886,3786,7672,edad 20
06434,Lanús,25,3546,3762,7308,edad 20
06434,Lanús,26,3598,3567,7165,edad 20
06434,Lanús,27,3314,3313,6627,edad 20
06434,Lanús,28,3224,3215,6439,edad 20
06434,Lanús,29,3140,3188,6328,edad 20
06434,Lanús,30,3237,3373,6610,edad 30
06434,Lanús,31,3029,3047,6076,edad 30
06434,Lanús,32,2797,3064,5861,edad 30
06434,Lanús,33,2852,2888,5740,edad 30
06434,Lanús,34,2669,2759,5428,edad 30
06434,Lanús,35,2714,2933,5647,edad 30
06434,Lanús,36,2684,2951,5635,edad 30
06434,Lanús,37,2654,2872,5526,edad 30
06434,Lanús,38,2893,3016,5909,edad 30
06434,Lanús,39,2669,2849,5518,edad 30
06434,Lanús,40,2797,3070,5867,edad 40
06434,Lanús,41,2816,2872,5688,edad 40
06434,Lanús,42,2745,3161,5906,edad 40
06434,Lanús,43,2719,2885,5604,edad 40
06434,Lanús,44,2585,2851,5436,edad 40
06434,Lanús,45,2774,3020,5794,edad 40
06434,Lanús,46,2627,2961,5588,edad 40
06434,Lanús,47,2621,2868,5489,edad 40
06434,Lanús,48,2558,2786,5344,edad 40
06434,Lanús,49,2354,2823,5177,edad 40
06434,Lanús,50,2639,3117,5756,edad 50
06434,Lanús,51,2561,2754,5315,edad 50
06434,Lanús,52,2531,2753,5284,edad 50
06434,Lanús,53,2505,2760,5265,edad 50
06434,Lanús,54,2291,2543,4834,edad 50
06434,Lanús,55,2233,2446,4679,edad 50
06434,Lanús,56,2269,2699,4968,edad 50
06434,Lanús,57,2021,2373,4394,edad 50
06434,Lanús,58,1926,2265,4191,edad 50
06434,Lanús,59,1756,2083,3839,edad 50
06434,Lanús,60,1839,2439,4278,edad 60
06434,Lanús,61,1765,2132,3897,edad 60
06434,Lanús,62,1772,2197,3969,edad 60
06434,Lanús,63,1753,2154,3907,edad 60
06434,Lanús,64,1637,2110,3747,edad 60
06434,Lanús,65,1741,2222,3963,edad 60
06434,Lanús,66,1617,2097,3714,edad 60
06434,Lanús,67,1637,2139,3776,edad 60
06434,Lanús,68,1566,2111,3677,edad 60
06434,Lanús,69,1519,2093,3612,edad 60
06434,Lanús,70,1621,2395,4016,edad 70
06434,Lanús,71,1480,2183,3663,edad 70
06434,Lanús,72,1393,2130,3523,edad 70
06434,Lanús,73,1337,2069,3406,edad 70
06434,Lanús,74,1216,1881,3097,edad 70
06434,Lanús,75,1295,2002,3297,edad 70
06434,Lanús,76,1149,1823,2972,edad 70
06434,Lanús,77,1011,1627,2638,edad 70
06434,Lanús,78,932,1561,2493,edad 70
06434,Lanús,79,834,1317,2151,edad 70
06434,Lanús,80,774,1367,2141,edad 80
06434,Lanús,81,603,1102,1705,edad 80
06434,Lanús,82,500,977,1477,edad 80
06434,Lanús,83,383,822,1205,edad 80
06434,Lanús,84,353,724,1077,edad 80
06434,Lanús,85,316,635,951,edad 80
06434,Lanús,86,231,583,814,edad 80
06434,Lanús,87,217,586,803,edad 80
06434,Lanús,88,167,465,632,edad 80
06434,Lanús,89,127,347,474,edad 80
06434,Lanús,90,92,260,352,edad 90
06434,Lanús,91,65,218,283,edad 90
06434,Lanús,92,62,159,221,edad 90
06434,Lanús,93,32,121,153,edad 90
06434,Lanús,94,34,94,128,edad 90
06434,Lanús,95,17,59,76,edad 90
06434,Lanús,96,26,56,82,edad 90
06434,Lanús,97,10,32,42,edad 90
06434,Lanús,98,7,20,27,edad 90
06434,Lanús,99,5,18,23,edad 90
06490,Lomas de Zamora,0,5243,5146,10389,edad 0
06490,Lomas de Zamora,1,4749,4471,9220,edad 0
06490,Lomas de Zamora,2,5416,5091,10507,edad 0
06490,Lomas de Zamora,3,4884,4673,9557,edad 0
06490,Lomas de Zamora,4,4961,4861,9822,edad 0
06490,Lomas de Zamora,5,5341,5238,10579,edad 0
06490,Lomas de Zamora,6,5223,5072,10295,edad 0
06490,Lomas de Zamora,7,5054,4874,9928,edad 0
06490,Lomas de Zamora,8,5213,4963,10176,edad 0
06490,Lomas de Zamora,9,5053,5005,10058,edad 0
06490,Lomas de Zamora,10,5594,5437,11031,edad 10
06490,Lomas de Zamora,11,5499,5042,10541,edad 10
06490,Lomas de Zamora,12,5217,5211,10428,edad 10
06490,Lomas de Zamora,13,5236,5098,10334,edad 10
06490,Lomas de Zamora,14,5283,5084,10367,edad 10
06490,Lomas de Zamora,15,5005,4983,9988,edad 10
06490,Lomas de Zamora,16,4993,4905,9898,edad 10
06490,Lomas de Zamora,17,4917,4888,9805,edad 10
06490,Lomas de Zamora,18,5045,4788,9833,edad 10
06490,Lomas de Zamora,19,5145,5259,10404,edad 10
06490,Lomas de Zamora,20,5377,5196,10573,edad 20
06490,Lomas de Zamora,21,5427,5556,10983,edad 20
06490,Lomas de Zamora,22,5347,5436,10783,edad 20
06490,Lomas de Zamora,23,5285,5275,10560,edad 20
06490,Lomas de Zamora,24,5182,5457,10639,edad 20
06490,Lomas de Zamora,25,4939,5070,10009,edad 20
06490,Lomas de Zamora,26,4761,4782,9543,edad 20
06490,Lomas de Zamora,27,4593,4591,9184,edad 20
06490,Lomas de Zamora,28,4442,4326,8768,edad 20
06490,Lomas de Zamora,29,4319,4349,8668,edad 20
06490,Lomas de Zamora,30,4477,4745,9222,edad 30
06490,Lomas de Zamora,31,3959,4123,8082,edad 30
06490,Lomas de Zamora,32,3889,4075,7964,edad 30
06490,Lomas de Zamora,33,3811,3805,7616,edad 30
06490,Lomas de Zamora,34,3486,3574,7060,edad 30
06490,Lomas de Zamora,35,3788,3778,7566,edad 30
06490,Lomas de Zamora,36,3612,3859,7471,edad 30
06490,Lomas de Zamora,37,3422,3730,7152,edad 30
06490,Lomas de Zamora,38,3595,3884,7479,edad 30
06490,Lomas de Zamora,39,3419,3630,7049,edad 30
06490,Lomas de Zamora,40,3593,3891,7484,edad 40
06490,Lomas de Zamora,41,3490,3649,7139,edad 40
06490,Lomas de Zamora,42,3664,3776,7440,edad 40
06490,Lomas de Zamora,43,3413,3590,7003,edad 40
06490,Lomas de Zamora,44,3204,3414,6618,edad 40
06490,Lomas de Zamora,45,3347,3532,6879,edad 40
06490,Lomas de Zamora,46,3168,3475,6643,edad 40
06490,Lomas de Zamora,47,3115,3381,6496,edad 40
06490,Lomas de Zamora,48,3150,3408,6558,edad 40
06490,Lomas de Zamora,49,2970,3271,6241,edad 40
06490,Lomas de Zamora,50,3285,3729,7014,edad 50
06490,Lomas de Zamora,51,2974,3276,6250,edad 50
06490,Lomas de Zamora,52,3055,3335,6390,edad 50
06490,Lomas de Zamora,53,2852,3195,6047,edad 50
06490,Lomas de Zamora,54,2688,3147,5835,edad 50
06490,Lomas de Zamora,55,2708,3048,5756,edad 50
06490,Lomas de Zamora,56,2896,3131,6027,edad 50
06490,Lomas de Zamora,57,2433,2773,5206,edad 50
06490,Lomas de Zamora,58,2368,2683,5051,edad 50
06490,Lomas de Zamora,59,2092,2462,4554,edad 50
06490,Lomas de Zamora,60,2270,2741,5011,edad 60
06490,Lomas de Zamora,61,2087,2374,4461,edad 60
06490,Lomas de Zamora,62,2013,2456,4469,edad 60
06490,Lomas de Zamora,63,1944,2334,4278,edad 60
06490,Lomas de Zamora,64,1837,2276,4113,edad 60
06490,Lomas de Zamora,65,1895,2474,4369,edad 60
06490,Lomas de Zamora,66,1728,2146,3874,edad 60
06490,Lomas de Zamora,67,1732,2082,3814,edad 60
06490,Lomas de Zamora,68,1691,2213,3904,edad 60
06490,Lomas de Zamora,69,1620,2126,3746,edad 60
06490,Lomas de Zamora,70,1614,2395,4009,edad 70
06490,Lomas de Zamora,71,1563,2001,3564,edad 70
06490,Lomas de Zamora,72,1428,2103,3531,edad 70
06490,Lomas de Zamora,73,1345,1888,3233,edad 70
06490,Lomas de Zamora,74,1216,1843,3059,edad 70
06490,Lomas de Zamora,75,1216,1865,3081,edad 70
06490,Lomas de Zamora,76,1079,1717,2796,edad 70
06490,Lomas de Zamora,77,985,1519,2504,edad 70
06490,Lomas de Zamora,78,920,1577,2497,edad 70
06490,Lomas de Zamora,79,776,1282,2058,edad 70
06490,Lomas de Zamora,80,720,1346,2066,edad 80
06490,Lomas de Zamora,81,559,1062,1621,edad 80
06490,Lomas de Zamora,82,465,968,1433,edad 80
06490,Lomas de Zamora,83,428,790,1218,edad 80
06490,Lomas de Zamora,84,314,751,1065,edad 80
06490,Lomas de Zamora,85,312,727,1039,edad 80
06490,Lomas de Zamora,86,272,653,925,edad 80
06490,Lomas de Zamora,87,201,561,762,edad 80
06490,Lomas de Zamora,88,198,420,618,edad 80
06490,Lomas de Zamora,89,123,360,483,edad 80
06490,Lomas de Zamora,90,117,319,436,edad 90
06490,Lomas de Zamora,91,75,235,310,edad 90
06490,Lomas de Zamora,92,54,191,245,edad 90
06490,Lomas de Zamora,93,43,124,167,edad 90
06490,Lomas de Zamora,94,31,95,126,edad 90
06490,Lomas de Zamora,95,24,75,99,edad 90
06490,Lomas de Zamora,96,17,52,69,edad 90
06490,Lomas de Zamora,97,5,28,33,edad 90
06490,Lomas de Zamora,98,8,34,42,edad 90
06490,Lomas de Zamora,99,7,21,28,edad 90
06515,Malvinas Argentinas,0,2941,2872,5813,edad 0
06515,Malvinas Argentinas,1,2877,2575,5452,edad 0
06515,Malvinas Argentinas,2,3166,2978,6144,edad 0
06515,Malvinas Argentinas,3,3054,2863,5917,edad 0
06515,Malvinas Argentinas,4,3043,2937,5980,edad 0
06515,Malvinas Argentinas,5,3111,3132,6243,edad 0
06515,Malvinas Argentinas,6,3062,2881,5943,edad 0
06515,Malvinas Argentinas,7,2968,2899,5867,edad 0
06515,Malvinas Argentinas,8,3012,2926,5938,edad 0
06515,Malvinas Argentinas,9,2915,2942,5857,edad 0
06515,Malvinas Argentinas,10,3219,3022,6241,edad 10
06515,Malvinas Argentinas,11,3054,2874,5928,edad 10
06515,Malvinas Argentinas,12,2961,2825,5786,edad 10
06515,Malvinas Argentinas,13,2869,2839,5708,edad 10
06515,Malvinas Argentinas,14,2808,2856,5664,edad 10
06515,Malvinas Argentinas,15,2786,2810,5596,edad 10
06515,Malvinas Argentinas,16,2719,2660,5379,edad 10
06515,Malvinas Argentinas,17,2573,2641,5214,edad 10
06515,Malvinas Argentinas,18,2643,2520,5163,edad 10
06515,Malvinas Argentinas,19,2717,2808,5525,edad 10
06515,Malvinas Argentinas,20,2669,2782,5451,edad 20
06515,Malvinas Argentinas,21,2869,2863,5732,edad 20
06515,Malvinas Argentinas,22,2690,2785,5475,edad 20
06515,Malvinas Argentinas,23,2710,2798,5508,edad 20
06515,Malvinas Argentinas,24,2545,2654,5199,edad 20
06515,Malvinas Argentinas,25,2505,2510,5015,edad 20
06515,Malvinas Argentinas,26,2348,2475,4823,edad 20
06515,Malvinas Argentinas,27,2258,2296,4554,edad 20
06515,Malvinas Argentinas,28,2192,2189,4381,edad 20
06515,Malvinas Argentinas,29,2178,2222,4400,edad 20
06515,Malvinas Argentinas,30,2375,2350,4725,edad 30
06515,Malvinas Argentinas,31,1992,2117,4109,edad 30
06515,Malvinas Argentinas,32,2049,1986,4035,edad 30
06515,Malvinas Argentinas,33,1918,1952,3870,edad 30
06515,Malvinas Argentinas,34,1777,1723,3500,edad 30
06515,Malvinas Argentinas,35,1868,1917,3785,edad 30
06515,Malvinas Argentinas,36,1895,1904,3799,edad 30
06515,Malvinas Argentinas,37,1745,1803,3548,edad 30
06515,Malvinas Argentinas,38,1857,1848,3705,edad 30
06515,Malvinas Argentinas,39,1644,1756,3400,edad 30
06515,Malvinas Argentinas,40,1725,1773,3498,edad 40
06515,Malvinas Argentinas,41,1738,1722,3460,edad 40
06515,Malvinas Argentinas,42,1864,1790,3654,edad 40
06515,Malvinas Argentinas,43,1616,1741,3357,edad 40
06515,Malvinas Argentinas,44,1486,1570,3056,edad 40
06515,Malvinas Argentinas,45,1632,1584,3216,edad 40
06515,Malvinas Argentinas,46,1527,1609,3136,edad 40
06515,Malvinas Argentinas,47,1527,1604,3131,edad 40
06515,Malvinas Argentinas,48,1493,1599,3092,edad 40
06515,Malvinas Argentinas,49,1389,1464,2853,edad 40
06515,Malvinas Argentinas,50,1540,1647,3187,edad 50
06515,Malvinas Argentinas,51,1460,1484,2944,edad 50
06515,Malvinas Argentinas,52,1469,1458,2927,edad 50
06515,Malvinas Argentinas,53,1394,1498,2892,edad 50
06515,Malvinas Argentinas,54,1231,1340,2571,edad 50
06515,Malvinas Argentinas,55,1166,1173,2339,edad 50
06515,Malvinas Argentinas,56,1287,1359,2646,edad 50
06515,Malvinas Argentinas,57,1075,1111,2186,edad 50
06515,Malvinas Argentinas,58,1120,1069,2189,edad 50
06515,Malvinas Argentinas,59,965,940,1905,edad 50
06515,Malvinas Argentinas,60,990,1083,2073,edad 60
06515,Malvinas Argentinas,61,876,961,1837,edad 60
06515,Malvinas Argentinas,62,901,935,1836,edad 60
06515,Malvinas Argentinas,63,818,900,1718,edad 60
06515,Malvinas Argentinas,64,784,890,1674,edad 60
06515,Malvinas Argentinas,65,793,848,1641,edad 60
06515,Malvinas Argentinas,66,610,776,1386,edad 60
06515,Malvinas Argentinas,67,649,742,1391,edad 60
06515,Malvinas Argentinas,68,582,718,1300,edad 60
06515,Malvinas Argentinas,69,614,679,1293,edad 60
06515,Malvinas Argentinas,70,582,692,1274,edad 70
06515,Malvinas Argentinas,71,510,685,1195,edad 70
06515,Malvinas Argentinas,72,481,626,1107,edad 70
06515,Malvinas Argentinas,73,423,592,1015,edad 70
06515,Malvinas Argentinas,74,423,538,961,edad 70
06515,Malvinas Argentinas,75,350,505,855,edad 70
06515,Malvinas Argentinas,76,337,457,794,edad 70
06515,Malvinas Argentinas,77,261,384,645,edad 70
06515,Malvinas Argentinas,78,235,401,636,edad 70
06515,Malvinas Argentinas,79,212,337,549,edad 70
06515,Malvinas Argentinas,80,186,298,484,edad 80
06515,Malvinas Argentinas,81,158,280,438,edad 80
06515,Malvinas Argentinas,82,112,219,331,edad 80
06515,Malvinas Argentinas,83,101,174,275,edad 80
06515,Malvinas Argentinas,84,80,162,242,edad 80
06515,Malvinas Argentinas,85,61,132,193,edad 80
06515,Malvinas Argentinas,86,59,132,191,edad 80
06515,Malvinas Argentinas,87,68,115,183,edad 80
06515,Malvinas Argentinas,88,41,87,128,edad 80
06515,Malvinas Argentinas,89,35,65,100,edad 80
06515,Malvinas Argentinas,90,36,60,96,edad 90
06515,Malvinas Argentinas,91,22,48,70,edad 90
06515,Malvinas Argentinas,92,19,40,59,edad 90
06515,Malvinas Argentinas,93,9,26,35,edad 90
06515,Malvinas Argentinas,94,6,19,25,edad 90
06515,Malvinas Argentinas,95,3,11,14,edad 90
06515,Malvinas Argentinas,96,0,14,14,edad 90
06515,Malvinas Argentinas,97,2,7,9,edad 90
06515,Malvinas Argentinas,98,4,4,8,edad 90
06515,Malvinas Argentinas,99,3,1,4,edad 90
06539,Merlo,0,4668,4415,9083,edad 0
06539,Merlo,1,4504,4260,8764,edad 0
06539,Merlo,2,4929,4707,9636,edad 0
06539,Merlo,3,4843,4587,9430,edad 0
06539,Merlo,4,4749,4663,9412,edad 0
06539,Merlo,5,5241,5066,10307,edad 0
06539,Merlo,6,5108,4798,9906,edad 0
06539,Merlo,7,4954,4650,9604,edad 0
06539,Merlo,8,4857,4662,9519,edad 0
06539,Merlo,9,4965,4679,9644,edad 0
06539,Merlo,10,5231,5029,10260,edad 10
06539,Merlo,11,4967,4875,9842,edad 10
06539,Merlo,12,4748,4834,9582,edad 10
06539,Merlo,13,4679,4722,9401,edad 10
06539,Merlo,14,4662,4638,9300,edad 10
06539,Merlo,15,4567,4435,9002,edad 10
06539,Merlo,16,4266,4219,8485,edad 10
06539,Merlo,17,4270,4232,8502,edad 10
06539,Merlo,18,4320,4285,8605,edad 10
06539,Merlo,19,4461,4604,9065,edad 10
06539,Merlo,20,4446,4504,8950,edad 20
06539,Merlo,21,4496,4494,8990,edad 20
06539,Merlo,22,4476,4434,8910,edad 20
06539,Merlo,23,4392,4380,8772,edad 20
06539,Merlo,24,4353,4370,8723,edad 20
06539,Merlo,25,3945,3942,7887,edad 20
06539,Merlo,26,3661,3748,7409,edad 20
06539,Merlo,27,3482,3565,7047,edad 20
06539,Merlo,28,3479,3603,7082,edad 20
06539,Merlo,29,3324,3407,6731,edad 20
06539,Merlo,30,3661,3741,7402,edad 30
06539,Merlo,31,3377,3253,6630,edad 30
06539,Merlo,32,3205,3219,6424,edad 30
06539,Merlo,33,2939,3146,6085,edad 30
06539,Merlo,34,2890,2830,5720,edad 30
06539,Merlo,35,2844,3002,5846,edad 30
06539,Merlo,36,2887,2933,5820,edad 30
06539,Merlo,37,2737,2886,5623,edad 30
06539,Merlo,38,2927,2999,5926,edad 30
06539,Merlo,39,2688,2923,5611,edad 30
06539,Merlo,40,2741,2940,5681,edad 40
06539,Merlo,41,2741,2900,5641,edad 40
06539,Merlo,42,2937,2940,5877,edad 40
06539,Merlo,43,2719,2732,5451,edad 40
06539,Merlo,44,2416,2557,4973,edad 40
06539,Merlo,45,2677,2690,5367,edad 40
06539,Merlo,46,2562,2605,5167,edad 40
06539,Merlo,47,2477,2571,5048,edad 40
06539,Merlo,48,2552,2648,5200,edad 40
06539,Merlo,49,2306,2416,4722,edad 40
06539,Merlo,50,2490,2706,5196,edad 50
06539,Merlo,51,2386,2397,4783,edad 50
06539,Merlo,52,2341,2334,4675,edad 50
06539,Merlo,53,2286,2363,4649,edad 50
06539,Merlo,54,2032,2140,4172,edad 50
06539,Merlo,55,1835,1915,3750,edad 50
06539,Merlo,56,2056,2073,4129,edad 50
06539,Merlo,57,1794,1778,3572,edad 50
06539,Merlo,58,1672,1648,3320,edad 50
06539,Merlo,59,1466,1552,3018,edad 50
06539,Merlo,60,1510,1678,3188,edad 60
06539,Merlo,61,1376,1484,2860,edad 60
06539,Merlo,62,1283,1432,2715,edad 60
06539,Merlo,63,1290,1441,2731,edad 60
06539,Merlo,64,1140,1360,2500,edad 60
06539,Merlo,65,1215,1360,2575,edad 60
06539,Merlo,66,988,1244,2232,edad 60
06539,Merlo,67,982,1106,2088,edad 60
06539,Merlo,68,924,1203,2127,edad 60
06539,Merlo,69,905,1159,2064,edad 60
06539,Merlo,70,912,1294,2206,edad 70
06539,Merlo,71,807,1198,2005,edad 70
06539,Merlo,72,860,1117,1977,edad 70
06539,Merlo,73,700,1022,1722,edad 70
06539,Merlo,74,670,990,1660,edad 70
06539,Merlo,75,586,891,1477,edad 70
06539,Merlo,76,538,890,1428,edad 70
06539,Merlo,77,506,741,1247,edad 70
06539,Merlo,78,459,776,1235,edad 70
06539,Merlo,79,378,613,991,edad 70
06539,Merlo,80,368,630,998,edad 80
06539,Merlo,81,283,513,796,edad 80
06539,Merlo,82,215,430,645,edad 80
06539,Merlo,83,193,381,574,edad 80
06539,Merlo,84,170,306,476,edad 80
06539,Merlo,85,140,280,420,edad 80
06539,Merlo,86,95,258,353,edad 80
06539,Merlo,87,91,219,310,edad 80
06539,Merlo,88,72,175,247,edad 80
06539,Merlo,89,52,143,195,edad 80
06539,Merlo,90,46,148,194,edad 90
06539,Merlo,91,26,88,114,edad 90
06539,Merlo,92,17,56,73,edad 90
06539,Merlo,93,17,53,70,edad 90
06539,Merlo,94,18,34,52,edad 90
06539,Merlo,95,11,25,36,edad 90
06539,Merlo,96,5,16,21,edad 90
06539,Merlo,97,5,18,23,edad 90
06539,Merlo,98,3,8,11,edad 90
06539,Merlo,99,1,8,9,edad 90
06560,Moreno,0,4181,4111,8292,edad 0
06560,Moreno,1,3928,3706,7634,edad 0
06560,Moreno,2,4456,4374,8830,edad 0
06560,Moreno,3,4121,3943,8064,edad 0
06560,Moreno,4,4328,4074,8402,edad 0
06560,Moreno,5,4516,4345,8861,edad 0
06560,Moreno,6,4514,4356,8870,edad 0
06560,Moreno,7,4354,4075,8429,edad 0
06560,Moreno,8,4366,3994,8360,edad 0
06560,Moreno,9,4283,4080,8363,edad 0
06560,Moreno,10,4487,4375,8862,edad 10
06560,Moreno,11,4465,4110,8575,edad 10
06560,Moreno,12,4086,4160,8246,edad 10
06560,Moreno,13,3974,3925,7899,edad 10
06560,Moreno,14,3912,3828,7740,edad 10
06560,Moreno,15,3941,3800,7741,edad 10
06560,Moreno,16,3606,3578,7184,edad 10
06560,Moreno,17,3549,3508,7057,edad 10
06560,Moreno,18,3565,3451,7016,edad 10
06560,Moreno,19,3728,3581,7309,edad 10
06560,Moreno,20,3517,3647,7164,edad 20
06560,Moreno,21,3714,3682,7396,edad 20
06560,Moreno,22,3441,3605,7046,edad 20
06560,Moreno,23,3404,3424,6828,edad 20
06560,Moreno,24,3419,3384,6803,edad 20
06560,Moreno,25,3028,3153,6181,edad 20
06560,Moreno,26,2810,3139,5949,edad 20
06560,Moreno,27,2828,2941,5769,edad 20
06560,Moreno,28,2811,2864,5675,edad 20
06560,Moreno,29,2646,2892,5538,edad 20
06560,Moreno,30,2870,3128,5998,edad 30
06560,Moreno,31,2607,2597,5204,edad 30
06560,Moreno,32,2527,2652,5179,edad 30
06560,Moreno,33,2538,2506,5044,edad 30
06560,Moreno,34,2206,2316,4522,edad 30
06560,Moreno,35,2377,2417,4794,edad 30
06560,Moreno,36,2372,2465,4837,edad 30
06560,Moreno,37,2140,2298,4438,edad 30
06560,Moreno,38,2454,2437,4891,edad 30
06560,Moreno,39,2187,2321,4508,edad 30
06560,Moreno,40,2308,2452,4760,edad 40
06560,Moreno,41,2255,2310,4565,edad 40
06560,Moreno,42,2427,2398,4825,edad 40
06560,Moreno,43,2175,2236,4411,edad 40
06560,Moreno,44,1982,2045,4027,edad 40
06560,Moreno,45,2101,2215,4316,edad 40
06560,Moreno,46,2017,2079,4096,edad 40
06560,Moreno,47,1999,2034,4033,edad 40
06560,Moreno,48,1996,1980,3976,edad 40
06560,Moreno,49,1843,1886,3729,edad 40
06560,Moreno,50,1983,2010,3993,edad 50
06560,Moreno,51,1725,1869,3594,edad 50
06560,Moreno,52,1803,1776,3579,edad 50
06560,Moreno,53,1686,1735,3421,edad 50
06560,Moreno,54,1494,1508,3002,edad 50
06560,Moreno,55,1400,1322,2722,edad 50
06560,Moreno,56,1587,1509,3096,edad 50
06560,Moreno,57,1255,1276,2531,edad 50
06560,Moreno,58,1201,1255,2456,edad 50
06560,Moreno,59,1040,1135,2175,edad 50
06560,Moreno,60,1099,1233,2332,edad 60
06560,Moreno,61,974,1003,1977,edad 60
06560,Moreno,62,954,1051,2005,edad 60
06560,Moreno,63,941,925,1866,edad 60
06560,Moreno,64,755,872,1627,edad 60
06560,Moreno,65,863,908,1771,edad 60
06560,Moreno,66,721,904,1625,edad 60
06560,Moreno,67,660,735,1395,edad 60
06560,Moreno,68,666,820,1486,edad 60
06560,Moreno,69,578,747,1325,edad 60
06560,Moreno,70,681,839,1520,edad 70
06560,Moreno,71,584,729,1313,edad 70
06560,Moreno,72,572,730,1302,edad 70
06560,Moreno,73,485,701,1186,edad 70
06560,Moreno,74,427,716,1143,edad 70
06560,Moreno,75,432,656,1088,edad 70
06560,Moreno,76,406,575,981,edad 70
06560,Moreno,77,313,466,779,edad 70
06560,Moreno,78,307,451,758,edad 70
06560,Moreno,79,238,382,620,edad 70
06560,Moreno,80,223,390,613,edad 80
06560,Moreno,81,179,274,453,edad 80
06560,Moreno,82,137,275,412,edad 80
06560,Moreno,83,142,271,413,edad 80
06560,Moreno,84,99,207,306,edad 80
06560,Moreno,85,79,155,234,edad 80
06560,Moreno,86,73,166,239,edad 80
06560,Moreno,87,68,150,218,edad 80
06560,Moreno,88,47,118,165,edad 80
06560,Moreno,89,29,84,113,edad 80
06560,Moreno,90,40,86,126,edad 90
06560,Moreno,91,24,60,84,edad 90
06560,Moreno,92,20,31,51,edad 90
06560,Moreno,93,13,42,55,edad 90
06560,Moreno,94,9,28,37,edad 90
06560,Moreno,95,5,18,23,edad 90
06560,Moreno,96,7,15,22,edad 90
06560,Moreno,97,4,10,14,edad 90
06560,Moreno,98,2,6,8,edad 90
06560,Moreno,99,3,7,10,edad 90
06568,Morón,0,2178,2024,4202,edad 0
06568,Morón,1,1832,1850,3682,edad 0
06568,Morón,2,2089,1897,3986,edad 0
06568,Morón,3,2018,1847,3865,edad 0
06568,Morón,4,2054,1926,3980,edad 0
06568,Morón,5,2134,2044,4178,edad 0
06568,Morón,6,2125,1995,4120,edad 0
06568,Morón,7,2080,1929,4009,edad 0
06568,Morón,8,2010,1947,3957,edad 0
06568,Morón,9,2139,2040,4179,edad 0
06568,Morón,10,2322,2265,4587,edad 10
06568,Morón,11,2405,2252,4657,edad 10
06568,Morón,12,2296,2364,4660,edad 10
06568,Morón,13,2360,2246,4606,edad 10
06568,Morón,14,2515,2365,4880,edad 10
06568,Morón,15,2438,2276,4714,edad 10
06568,Morón,16,2288,2242,4530,edad 10
06568,Morón,17,2261,2367,4628,edad 10
06568,Morón,18,2431,2165,4596,edad 10
06568,Morón,19,2684,2453,5137,edad 10
06568,Morón,20,2621,2519,5140,edad 20
06568,Morón,21,2754,2694,5448,edad 20
06568,Morón,22,2755,2642,5397,edad 20
06568,Morón,23,2763,2626,5389,edad 20
06568,Morón,24,2655,2603,5258,edad 20
06568,Morón,25,2567,2504,5071,edad 20
06568,Morón,26,2402,2365,4767,edad 20
06568,Morón,27,2309,2249,4558,edad 20
06568,Morón,28,2081,2201,4282,edad 20
06568,Morón,29,1990,2116,4106,edad 20
06568,Morón,30,2146,2193,4339,edad 30
06568,Morón,31,2021,2042,4063,edad 30
06568,Morón,32,1897,2008,3905,edad 30
06568,Morón,33,1932,1933,3865,edad 30
06568,Morón,34,1743,1865,3608,edad 30
06568,Morón,35,1767,1971,3738,edad 30
06568,Morón,36,1889,1933,3822,edad 30
06568,Morón,37,1838,1975,3813,edad 30
06568,Morón,38,1811,2126,3937,edad 30
06568,Morón,39,1855,1947,3802,edad 30
06568,Morón,40,1873,2119,3992,edad 40
06568,Morón,41,1875,2056,3931,edad 40
06568,Morón,42,1937,2210,4147,edad 40
06568,Morón,43,1867,2080,3947,edad 40
06568,Morón,44,1856,1962,3818,edad 40
06568,Morón,45,1792,2077,3869,edad 40
06568,Morón,46,1780,2056,3836,edad 40
06568,Morón,47,1733,2015,3748,edad 40
06568,Morón,48,1745,2033,3778,edad 40
06568,Morón,49,1715,1978,3693,edad 40
06568,Morón,50,1813,2282,4095,edad 50
06568,Morón,51,1783,1999,3782,edad 50
06568,Morón,52,1809,2019,3828,edad 50
06568,Morón,53,1803,2016,3819,edad 50
06568,Morón,54,1632,1842,3474,edad 50
06568,Morón,55,1661,1892,3553,edad 50
06568,Morón,56,1561,1922,3483,edad 50
06568,Morón,57,1468,1654,3122,edad 50
06568,Morón,58,1345,1712,3057,edad 50
06568,Morón,59,1322,1579,2901,edad 50
06568,Morón,60,1323,1663,2986,edad 60
06568,Morón,61,1195,1600,2795,edad 60
06568,Morón,62,1265,1558,2823,edad 60
06568,Morón,63,1201,1574,2775,edad 60
06568,Morón,64,1122,1493,2615,edad 60
06568,Morón,65,1273,1610,2883,edad 60
06568,Morón,66,1119,1467,2586,edad 60
06568,Morón,67,1146,1490,2636,edad 60
06568,Morón,68,1135,1497,2632,edad 60
06568,Morón,69,1086,1438,2524,edad 60
06568,Morón,70,1149,1682,2831,edad 70
06568,Morón,71,1124,1488,2612,edad 70
06568,Morón,72,1110,1606,2716,edad 70
06568,Morón,73,985,1605,2590,edad 70
06568,Morón,74,961,1443,2404,edad 70
06568,Morón,75,928,1361,2289,edad 70
06568,Morón,76,848,1339,2187,edad 70
06568,Morón,77,728,1162,1890,edad 70
06568,Morón,78,740,1206,1946,edad 70
06568,Morón,79,605,1036,1641,edad 70
06568,Morón,80,558,979,1537,edad 80
06568,Morón,81,465,873,1338,edad 80
06568,Morón,82,391,746,1137,edad 80
06568,Morón,83,315,630,945,edad 80
06568,Morón,84,281,545,826,edad 80
06568,Morón,85,267,493,760,edad 80
06568,Morón,86,201,430,631,edad 80
06568,Morón,87,169,422,591,edad 80
06568,Morón,88,126,288,414,edad 80
06568,Morón,89,117,271,388,edad 80
06568,Morón,90,87,244,331,edad 90
06568,Morón,91,53,165,218,edad 90
06568,Morón,92,45,126,171,edad 90
06568,Morón,93,26,97,123,edad 90
06568,Morón,94,17,77,94,edad 90
06568,Morón,95,14,29,43,edad 90
06568,Morón,96,8,42,50,edad 90
06568,Morón,97,11,22,33,edad 90
06568,Morón,98,4,10,14,edad 90
06568,Morón,99,3,18,21,edad 90
06658,Quilmes,0,4643,4515,9158,edad 0
06658,Quilmes,1,4166,4085,8251,edad 0
06658,Quilmes,2,4709,4552,9261,edad 0
06658,Quilmes,3,4265,4167,8432,edad 0
06658,Quilmes,4,4370,4374,8744,edad 0
06658,Quilmes,5,4682,4472,9154,edad 0
06658,Quilmes,6,4517,4369,8886,edad 0
06658,Quilmes,7,4499,4289,8788,edad 0
06658,Quilmes,8,4472,4291,8763,edad 0
06658,Quilmes,9,4472,4309,8781,edad 0
06658,Quilmes,10,4871,4842,9713,edad 10
06658,Quilmes,11,4711,4598,9309,edad 10
06658,Quilmes,12,4721,4433,9154,edad 10
06658,Quilmes,13,4618,4434,9052,edad 10
06658,Quilmes,14,4479,4501,8980,edad 10
06658,Quilmes,15,4570,4343,8913,edad 10
06658,Quilmes,16,4370,4123,8493,edad 10
06658,Quilmes,17,4335,4293,8628,edad 10
06658,Quilmes,18,4255,4319,8574,edad 10
06658,Quilmes,19,4550,4706,9256,edad 10
06658,Quilmes,20,4625,4630,9255,edad 20
06658,Quilmes,21,4841,4950,9791,edad 20
06658,Quilmes,22,4680,4822,9502,edad 20
06658,Quilmes,23,4587,4591,9178,edad 20
06658,Quilmes,24,4594,4592,9186,edad 20
06658,Quilmes,25,4203,4328,8531,edad 20
06658,Quilmes,26,4001,4101,8102,edad 20
06658,Quilmes,27,3952,3864,7816,edad 20
06658,Quilmes,28,3885,3892,7777,edad 20
06658,Quilmes,29,3659,3810,7469,edad 20
06658,Quilmes,30,3993,3990,7983,edad 30
06658,Quilmes,31,3501,3583,7084,edad 30
06658,Quilmes,32,3311,3580,6891,edad 30
06658,Quilmes,33,3342,3410,6752,edad 30
06658,Quilmes,34,3200,3198,6398,edad 30
06658,Quilmes,35,3218,3287,6505,edad 30
06658,Quilmes,36,3163,3297,6460,edad 30
06658,Quilmes,37,2935,3162,6097,edad 30
06658,Quilmes,38,3154,3427,6581,edad 30
06658,Quilmes,39,2944,3222,6166,edad 30
06658,Quilmes,40,3134,3338,6472,edad 40
06658,Quilmes,41,3221,3177,6398,edad 40
06658,Quilmes,42,3082,3422,6504,edad 40
06658,Quilmes,43,2981,3303,6284,edad 40
06658,Quilmes,44,2747,2927,5674,edad 40
06658,Quilmes,45,3062,3132,6194,edad 40
06658,Quilmes,46,2779,3137,5916,edad 40
06658,Quilmes,47,2809,3066,5875,edad 40
06658,Quilmes,48,2823,3086,5909,edad 40
06658,Quilmes,49,2655,3014,5669,edad 40
06658,Quilmes,50,2948,3400,6348,edad 50
06658,Quilmes,51,2684,2935,5619,edad 50
06658,Quilmes,52,2729,3044,5773,edad 50
06658,Quilmes,53,2733,2763,5496,edad 50
06658,Quilmes,54,2412,2760,5172,edad 50
06658,Quilmes,55,2274,2604,4878,edad 50
06658,Quilmes,56,2465,2680,5145,edad 50
06658,Quilmes,57,2109,2386,4495,edad 50
06658,Quilmes,58,2050,2334,4384,edad 50
06658,Quilmes,59,1909,2121,4030,edad 50
06658,Quilmes,60,1978,2522,4500,edad 60
06658,Quilmes,61,1808,2139,3947,edad 60
06658,Quilmes,62,1824,2217,4041,edad 60
06658,Quilmes,63,1730,2086,3816,edad 60
06658,Quilmes,64,1644,1959,3603,edad 60
06658,Quilmes,65,1769,2150,3919,edad 60
06658,Quilmes,66,1512,1954,3466,edad 60
06658,Quilmes,67,1474,1858,3332,edad 60
06658,Quilmes,68,1461,1890,3351,edad 60
06658,Quilmes,69,1333,1827,3160,edad 60
06658,Quilmes,70,1497,2108,3605,edad 70
06658,Quilmes,71,1355,1821,3176,edad 70
06658,Quilmes,72,1249,1823,3072,edad 70
06658,Quilmes,73,1254,1732,2986,edad 70
06658,Quilmes,74,1080,1691,2771,edad 70
06658,Quilmes,75,1085,1641,2726,edad 70
06658,Quilmes,76,996,1482,2478,edad 70
06658,Quilmes,77,847,1342,2189,edad 70
06658,Quilmes,78,865,1336,2201,edad 70
06658,Quilmes,79,725,1130,1855,edad 70
06658,Quilmes,80,642,1132,1774,edad 80
06658,Quilmes,81,555,803,1358,edad 80
06658,Quilmes,82,450,819,1269,edad 80
06658,Quilmes,83,326,664,990,edad 80
06658,Quilmes,84,290,605,895,edad 80
06658,Quilmes,85,231,551,782,edad 80
06658,Quilmes,86,201,524,725,edad 80
06658,Quilmes,87,172,474,646,edad 80
06658,Quilmes,88,154,346,500,edad 80
06658,Quilmes,89,120,278,398,edad 80
06658,Quilmes,90,87,258,345,edad 90
06658,Quilmes,91,65,157,222,edad 90
06658,Quilmes,92,39,135,174,edad 90
06658,Quilmes,93,26,123,149,edad 90
06658,Quilmes,94,18,82,100,edad 90
06658,Quilmes,95,12,54,66,edad 90
06658,Quilmes,96,11,39,50,edad 90
06658,Quilmes,97,10,23,33,edad 90
06658,Quilmes,98,5,19,24,edad 90
06658,Quilmes,99,5,14,19,edad 90
06749,San Fernando,0,1278,1235,2513,edad 0
06749,San Fernando,1,1199,1081,2280,edad 0
06749,San Fernando,2,1352,1290,2642,edad 0
06749,San Fernando,3,1297,1206,2503,edad 0
06749,San Fernando,4,1372,1262,2634,edad 0
06749,San Fernando,5,1428,1335,2763,edad 0
06749,San Fernando,6,1311,1309,2620,edad 0
06749,San Fernando,7,1313,1304,2617,edad 0
06749,San Fernando,8,1306,1218,2524,edad 0
06749,San Fernando,9,1307,1323,2630,edad 0
06749,San Fernando,10,1401,1370,2771,edad 10
06749,San Fernando,11,1373,1358,2731,edad 10
06749,San Fernando,12,1367,1313,2680,edad 10
06749,San Fernando,13,1287,1343,2630,edad 10
06749,San Fernando,14,1332,1298,2630,edad 10
06749,San Fernando,15,1322,1205,2527,edad 10
06749,San Fernando,16,1260,1175,2435,edad 10
06749,San Fernando,17,1182,1195,2377,edad 10
06749,San Fernando,18,1261,1238,2499,edad 10
06749,San Fernando,19,1371,1225,2596,edad 10
06749,San Fernando,20,1284,1323,2607,edad 20
06749,San Fernando,21,1397,1353,2750,edad 20
06749,San Fernando,22,1313,1336,2649,edad 20
06749,San Fernando,23,1298,1377,2675,edad 20
06749,San Fernando,24,1229,1343,2572,edad 20
06749,San Fernando,25,1256,1304,2560,edad 20
06749,San Fernando,26,1137,1202,2339,edad 20
06749,San Fernando,27,1097,1130,2227,edad 20
06749,San Fernando,28,1143,1148,2291,edad 20
06749,San Fernando,29,1011,1099,2110,edad 20
06749,San Fernando,30,1149,1148,2297,edad 30
06749,San Fernando,31,1042,1111,2153,edad 30
06749,San Fernando,32,1025,1115,2140,edad 30
06749,San Fernando,33,995,1095,2090,edad 30
06749,San Fernando,34,948,978,1926,edad 30
06749,San Fernando,35,962,1069,2031,edad 30
06749,San Fernando,36,938,1026,1964,edad 30
06749,San Fernando,37,956,945,1901,edad 30
06749,San Fernando,38,954,964,1918,edad 30
06749,San Fernando,39,903,949,1852,edad 30
06749,San Fernando,40,874,1054,1928,edad 40
06749,San Fernando,41,961,923,1884,edad 40
06749,San Fernando,42,975,989,1964,edad 40
06749,San Fernando,43,852,927,1779,edad 40
06749,San Fernando,44,791,852,1643,edad 40
06749,San Fernando,45,794,906,1700,edad 40
06749,San Fernando,46,843,892,1735,edad 40
06749,San Fernando,47,764,877,1641,edad 40
06749,San Fernando,48,834,872,1706,edad 40
06749,San Fernando,49,735,840,1575,edad 40
06749,San Fernando,50,773,892,1665,edad 50
06749,San Fernando,51,749,863,1612,edad 50
06749,San Fernando,52,767,863,1630,edad 50
06749,San Fernando,53,732,795,1527,edad 50
06749,San Fernando,54,635,750,1385,edad 50
06749,San Fernando,55,668,746,1414,edad 50
06749,San Fernando,56,680,811,1491,edad 50
06749,San Fernando,57,610,671,1281,edad 50
06749,San Fernando,58,596,692,1288,edad 50
06749,San Fernando,59,526,627,1153,edad 50
06749,San Fernando,60,607,712,1319,edad 60
06749,San Fernando,61,517,654,1171,edad 60
06749,San Fernando,62,531,603,1134,edad 60
06749,San Fernando,63,492,614,1106,edad 60
06749,San Fernando,64,476,577,1053,edad 60
06749,San Fernando,65,535,590,1125,edad 60
06749,San Fernando,66,459,604,1063,edad 60
06749,San Fernando,67,497,564,1061,edad 60
06749,San Fernando,68,438,598,1036,edad 60
06749,San Fernando,69,395,531,926,edad 60
06749,San Fernando,70,429,609,1038,edad 70
06749,San Fernando,71,424,518,942,edad 70
06749,San Fernando,72,373,578,951,edad 70
06749,San Fernando,73,370,503,873,edad 70
06749,San Fernando,74,339,479,818,edad 70
06749,San Fernando,75,316,480,796,edad 70
06749,San Fernando,76,306,473,779,edad 70
06749,San Fernando,77,259,401,660,edad 70
06749,San Fernando,78,250,355,605,edad 70
06749,San Fernando,79,191,317,508,edad 70
06749,San Fernando,80,198,337,535,edad 80
06749,San Fernando,81,155,265,420,edad 80
06749,San Fernando,82,132,262,394,edad 80
06749,San Fernando,83,96,253,349,edad 80
06749,San Fernando,84,95,209,304,edad 80
06749,San Fernando,85,70,189,259,edad 80
06749,San Fernando,86,65,179,244,edad 80
06749,San Fernando,87,59,173,232,edad 80
06749,San Fernando,88,38,114,152,edad 80
06749,San Fernando,89,47,107,154,edad 80
06749,San Fernando,90,36,81,117,edad 90
06749,San Fernando,91,28,71,99,edad 90
06749,San Fernando,92,13,57,70,edad 90
06749,San Fernando,93,13,47,60,edad 90
06749,San Fernando,94,5,26,31,edad 90
06749,San Fernando,95,5,13,18,edad 90
06749,San Fernando,96,2,19,21,edad 90
06749,San Fernando,97,3,12,15,edad 90
06749,San Fernando,98,2,17,19,edad 90
06749,San Fernando,99,3,7,10,edad 90
06756,San Isidro,0,2041,1911,3952,edad 0
06756,San Isidro,1,1910,1778,3688,edad 0
06756,San Isidro,2,2114,1920,4034,edad 0
06756,San Isidro,3,1971,1908,3879,edad 0
06756,San Isidro,4,1903,1964,3867,edad 0
06756,San Isidro,5,2082,1921,4003,edad 0
06756,San Isidro,6,2015,1889,3904,edad 0
06756,San Isidro,7,2032,1937,3969,edad 0
06756,San Isidro,8,2071,1945,4016,edad 0
06756,San Isidro,9,2024,1978,4002,edad 0
06756,San Isidro,10,2199,2153,4352,edad 10
06756,San Isidro,11,2187,2162,4349,edad 10
06756,San Isidro,12,2141,2149,4290,edad 10
06756,San Isidro,13,2156,2096,4252,edad 10
06756,San Isidro,14,2218,2299,4517,edad 10
06756,San Isidro,15,2221,2208,4429,edad 10
06756,San Isidro,16,2342,2164,4506,edad 10
06756,San Isidro,17,2313,2289,4602,edad 10
06756,San Isidro,18,2350,2276,4626,edad 10
06756,San Isidro,19,2341,2397,4738,edad 10
06756,San Isidro,20,2620,2425,5045,edad 20
06756,San Isidro,21,2620,2618,5238,edad 20
06756,San Isidro,22,2538,2541,5079,edad 20
06756,San Isidro,23,2516,2513,5029,edad 20
06756,San Isidro,24,2418,2507,4925,edad 20
06756,San Isidro,25,2382,2474,4856,edad 20
06756,San Isidro,26,2339,2393,4732,edad 20
06756,San Isidro,27,2141,2215,4356,edad 20
06756,San Isidro,28,2062,2189,4251,edad 20
06756,San Isidro,29,1889,2063,3952,edad 20
06756,San Isidro,30,2045,2365,4410,edad 30
06756,San Isidro,31,1908,1970,3878,edad 30
06756,San Isidro,32,1798,2032,3830,edad 30
06756,San Isidro,33,1716,1916,3632,edad 30
06756,San Isidro,34,1603,1825,3428,edad 30
06756,San Isidro,35,1766,1827,3593,edad 30
06756,San Isidro,36,1751,1949,3700,edad 30
06756,San Isidro,37,1681,1846,3527,edad 30
06756,San Isidro,38,1679,1973,3652,edad 30
06756,San Isidro,39,1611,1840,3451,edad 30
06756,San Isidro,40,1782,2074,3856,edad 40
06756,San Isidro,41,1732,1837,3569,edad 40
06756,San Isidro,42,1745,2040,3785,edad 40
06756,San Isidro,43,1738,1971,3709,edad 40
06756,San Isidro,44,1608,1861,3469,edad 40
06756,San Isidro,45,1695,2027,3722,edad 40
06756,San Isidro,46,1631,1882,3513,edad 40
06756,San Isidro,47,1654,1824,3478,edad 40
06756,San Isidro,48,1674,1954,3628,edad 40
06756,San Isidro,49,1567,1795,3362,edad 40
06756,San Isidro,50,1736,2085,3821,edad 50
06756,San Isidro,51,1616,1875,3491,edad 50
06756,San Isidro,52,1647,1918,3565,edad 50
06756,San Isidro,53,1532,1913,3445,edad 50
06756,San Isidro,54,1515,1806,3321,edad 50
06756,San Isidro,55,1545,1858,3403,edad 50
06756,San Isidro,56,1563,1785,3348,edad 50
06756,San Isidro,57,1411,1653,3064,edad 50
06756,San Isidro,58,1337,1558,2895,edad 50
06756,San Isidro,59,1189,1470,2659,edad 50
06756,San Isidro,60,1309,1638,2947,edad 60
06756,San Isidro,61,1129,1416,2545,edad 60
06756,San Isidro,62,1211,1474,2685,edad 60
06756,San Isidro,63,1157,1408,2565,edad 60
06756,San Isidro,64,1007,1292,2299,edad 60
06756,San Isidro,65,1082,1547,2629,edad 60
06756,San Isidro,66,951,1256,2207,edad 60
06756,San Isidro,67,1013,1290,2303,edad 60
06756,San Isidro,68,994,1333,2327,edad 60
06756,San Isidro,69,1008,1267,2275,edad 60
06756,San Isidro,70,1062,1470,2532,edad 70
06756,San Isidro,71,921,1324,2245,edad 70
06756,San Isidro,72,934,1369,2303,edad 70
06756,San Isidro,73,898,1284,2182,edad 70
06756,San Isidro,74,802,1262,2064,edad 70
06756,San Isidro,75,838,1253,2091,edad 70
06756,San Isidro,76,771,1162,1933,edad 70
06756,San Isidro,77,673,994,1667,edad 70
06756,San Isidro,78,692,1019,1711,edad 70
06756,San Isidro,79,501,856,1357,edad 70
06756,San Isidro,80,477,841,1318,edad 80
06756,San Isidro,81,418,714,1132,edad 80
06756,San Isidro,82,357,697,1054,edad 80
06756,San Isidro,83,283,542,825,edad 80
06756,San Isidro,84,231,521,752,edad 80
06756,San Isidro,85,203,465,668,edad 80
06756,San Isidro,86,187,433,620,edad 80
06756,San Isidro,87,159,403,562,edad 80
06756,San Isidro,88,136,365,501,edad 80
06756,San Isidro,89,112,235,347,edad 80
06756,San Isidro,90,96,223,319,edad 90
06756,San Isidro,91,46,179,225,edad 90
06756,San Isidro,92,42,149,191,edad 90
06756,San Isidro,93,40,99,139,edad 90
06756,San Isidro,94,27,108,135,edad 90
06756,San Isidro,95,11,54,65,edad 90
06756,San Isidro,96,11,38,49,edad 90
06756,San Isidro,97,7,37,44,edad 90
06756,San Isidro,98,2,19,21,edad 90
06756,San Isidro,99,0,11,11,edad 90
06760,San Miguel,0,2471,2286,4757,edad 0
06760,San Miguel,1,2198,2175,4373,edad 0
06760,San Miguel,2,2434,2425,4859,edad 0
06760,San Miguel,3,2453,2381,4834,edad 0
06760,San Miguel,4,2408,2398,4806,edad 0
06760,San Miguel,5,2599,2525,5124,edad 0
06760,San Miguel,6,2522,2506,5028,edad 0
06760,San Miguel,7,2519,2416,4935,edad 0
06760,San Miguel,8,2446,2439,4885,edad 0
06760,San Miguel,9,2525,2477,5002,edad 0
06760,San Miguel,10,2578,2641,5219,edad 10
06760,San Miguel,11,2584,2541,5125,edad 10
06760,San Miguel,12,2539,2557,5096,edad 10
06760,San Miguel,13,2525,2401,4926,edad 10
06760,San Miguel,14,2536,2444,4980,edad 10
06760,San Miguel,15,2465,2388,4853,edad 10
06760,San Miguel,16,2300,2293,4593,edad 10
06760,San Miguel,17,2265,2329,4594,edad 10
06760,San Miguel,18,2253,2273,4526,edad 10
06760,San Miguel,19,2287,2384,4671,edad 10
06760,San Miguel,20,2351,2255,4606,edad 20
06760,San Miguel,21,2424,2377,4801,edad 20
06760,San Miguel,22,2294,2259,4553,edad 20
06760,San Miguel,23,2297,2228,4525,edad 20
06760,San Miguel,24,2230,2209,4439,edad 20
06760,San Miguel,25,2005,2026,4031,edad 20
06760,San Miguel,26,1981,1895,3876,edad 20
06760,San Miguel,27,1824,1917,3741,edad 20
06760,San Miguel,28,1900,1958,3858,edad 20
06760,San Miguel,29,1844,1820,3664,edad 20
06760,San Miguel,30,1917,2002,3919,edad 30
06760,San Miguel,31,1809,1779,3588,edad 30
06760,San Miguel,32,1630,1815,3445,edad 30
06760,San Miguel,33,1611,1772,3383,edad 30
06760,San Miguel,34,1541,1660,3201,edad 30
06760,San Miguel,35,1557,1631,3188,edad 30
06760,San Miguel,36,1563,1684,3247,edad 30
06760,San Miguel,37,1507,1656,3163,edad 30
06760,San Miguel,38,1628,1678,3306,edad 30
06760,San Miguel,39,1483,1622,3105,edad 30
06760,San Miguel,40,1526,1706,3232,edad 40
06760,San Miguel,41,1564,1502,3066,edad 40
06760,San Miguel,42,1582,1584,3166,edad 40
06760,San Miguel,43,1532,1562,3094,edad 40
06760,San Miguel,44,1323,1465,2788,edad 40
06760,San Miguel,45,1361,1519,2880,edad 40
06760,San Miguel,46,1346,1417,2763,edad 40
06760,San Miguel,47,1365,1377,2742,edad 40
06760,San Miguel,48,1392,1384,2776,edad 40
06760,San Miguel,49,1270,1368,2638,edad 40
06760,San Miguel,50,1257,1585,2842,edad 50
06760,San Miguel,51,1272,1309,2581,edad 50
06760,San Miguel,52,1259,1344,2603,edad 50
06760,San Miguel,53,1185,1310,2495,edad 50
06760,San Miguel,54,1173,1235,2408,edad 50
06760,San Miguel,55,1028,1088,2116,edad 50
06760,San Miguel,56,1117,1227,2344,edad 50
06760,San Miguel,57,951,1031,1982,edad 50
06760,San Miguel,58,879,965,1844,edad 50
06760,San Miguel,59,798,864,1662,edad 50
06760,San Miguel,60,891,967,1858,edad 60
06760,San Miguel,61,766,857,1623,edad 60
06760,San Miguel,62,818,862,1680,edad 60
06760,San Miguel,63,708,780,1488,edad 60
06760,San Miguel,64,667,740,1407,edad 60
06760,San Miguel,65,695,869,1564,edad 60
06760,San Miguel,66,621,709,1330,edad 60
06760,San Miguel,67,544,700,1244,edad 60
06760,San Miguel,68,574,722,1296,edad 60
06760,San Miguel,69,536,646,1182,edad 60
06760,San Miguel,70,525,771,1296,edad 70
06760,San Miguel,71,482,712,1194,edad 70
06760,San Miguel,72,459,633,1092,edad 70
06760,San Miguel,73,466,644,1110,edad 70
06760,San Miguel,74,372,609,981,edad 70
06760,San Miguel,75,372,575,947,edad 70
06760,San Miguel,76,356,575,931,edad 70
06760,San Miguel,77,330,486,816,edad 70
06760,San Miguel,78,268,456,724,edad 70
06760,San Miguel,79,231,338,569,edad 70
06760,San Miguel,80,222,416,638,edad 80
06760,San Miguel,81,184,350,534,edad 80
06760,San Miguel,82,162,280,442,edad 80
06760,San Miguel,83,111,251,362,edad 80
06760,San Miguel,84,117,245,362,edad 80
06760,San Miguel,85,83,176,259,edad 80
06760,San Miguel,86,72,183,255,edad 80
06760,San Miguel,87,70,154,224,edad 80
06760,San Miguel,88,56,138,194,edad 80
06760,San Miguel,89,47,110,157,edad 80
06760,San Miguel,90,23,82,105,edad 90
06760,San Miguel,91,17,83,100,edad 90
06760,San Miguel,92,22,50,72,edad 90
06760,San Miguel,93,9,42,51,edad 90
06760,San Miguel,94,10,39,49,edad 90
06760,San Miguel,95,7,15,22,edad 90
06760,San Miguel,96,5,18,23,edad 90
06760,San Miguel,97,7,18,25,edad 90
06760,San Miguel,98,7,7,14,edad 90
06760,San Miguel,99,4,5,9,edad 90
06805,Tigre,0,2929,2882,5811,edad 0
06805,Tigre,1,2794,2767,5561,edad 0
06805,Tigre,2,3026,3021,6047,edad 0
06805,Tigre,3,2971,2879,5850,edad 0
06805,Tigre,4,3044,2936,5980,edad 0
06805,Tigre,5,3145,3050,6195,edad 0
06805,Tigre,6,3072,2967,6039,edad 0
06805,Tigre,7,3013,2886,5899,edad 0
06805,Tigre,8,2881,2845,5726,edad 0
06805,Tigre,9,2990,2839,5829,edad 0
06805,Tigre,10,3073,3041,6114,edad 10
06805,Tigre,11,2994,2914,5908,edad 10
06805,Tigre,12,2858,2779,5637,edad 10
06805,Tigre,13,2832,2735,5567,edad 10
06805,Tigre,14,2860,2653,5513,edad 10
06805,Tigre,15,2711,2667,5378,edad 10
06805,Tigre,16,2651,2439,5090,edad 10
06805,Tigre,17,2498,2502,5000,edad 10
06805,Tigre,18,2570,2463,5033,edad 10
06805,Tigre,19,2635,2715,5350,edad 10
06805,Tigre,20,2584,2740,5324,edad 20
06805,Tigre,21,2793,2786,5579,edad 20
06805,Tigre,22,2637,2633,5270,edad 20
06805,Tigre,23,2614,2675,5289,edad 20
06805,Tigre,24,2663,2692,5355,edad 20
06805,Tigre,25,2475,2472,4947,edad 20
06805,Tigre,26,2386,2466,4852,edad 20
06805,Tigre,27,2219,2411,4630,edad 20
06805,Tigre,28,2234,2245,4479,edad 20
06805,Tigre,29,2167,2257,4424,edad 20
06805,Tigre,30,2311,2463,4774,edad 30
06805,Tigre,31,2122,2247,4369,edad 30
06805,Tigre,32,2006,2284,4290,edad 30
06805,Tigre,33,2079,2152,4231,edad 30
06805,Tigre,34,1882,1939,3821,edad 30
06805,Tigre,35,1988,2126,4114,edad 30
06805,Tigre,36,2017,2134,4151,edad 30
06805,Tigre,37,1863,2048,3911,edad 30
06805,Tigre,38,2009,2077,4086,edad 30
06805,Tigre,39,1878,1890,3768,edad 30
06805,Tigre,40,1891,1979,3870,edad 40
06805,Tigre,41,1853,1820,3673,edad 40
06805,Tigre,42,1924,1917,3841,edad 40
06805,Tigre,43,1831,1805,3636,edad 40
06805,Tigre,44,1625,1680,3305,edad 40
06805,Tigre,45,1725,1757,3482,edad 40
06805,Tigre,46,1601,1704,3305,edad 40
06805,Tigre,47,1569,1655,3224,edad 40
06805,Tigre,48,1676,1609,3285,edad 40
06805,Tigre,49,1503,1493,2996,edad 40
06805,Tigre,50,1579,1724,3303,edad 50
06805,Tigre,51,1578,1508,3086,edad 50
06805,Tigre,52,1544,1540,3084,edad 50
06805,Tigre,53,1368,1463,2831,edad 50
06805,Tigre,54,1268,1364,2632,edad 50
06805,Tigre,55,1248,1407,2655,edad 50
06805,Tigre,56,1397,1473,2870,edad 50
06805,Tigre,57,1147,1264,2411,edad 50
06805,Tigre,58,1156,1168,2324,edad 50
06805,Tigre,59,1072,1123,2195,edad 50
06805,Tigre,60,1099,1228,2327,edad 60
06805,Tigre,61,1005,1082,2087,edad 60
06805,Tigre,62,928,1045,1973,edad 60
06805,Tigre,63,959,1052,2011,edad 60
06805,Tigre,64,891,932,1823,edad 60
06805,Tigre,65,910,1006,1916,edad 60
06805,Tigre,66,733,897,1630,edad 60
06805,Tigre,67,792,810,1602,edad 60
06805,Tigre,68,723,854,1577,edad 60
06805,Tigre,69,668,846,1514,edad 60
06805,Tigre,70,745,827,1572,edad 70
06805,Tigre,71,656,816,1472,edad 70
06805,Tigre,72,618,729,1347,edad 70
06805,Tigre,73,543,731,1274,edad 70
06805,Tigre,74,505,677,1182,edad 70
06805,Tigre,75,452,630,1082,edad 70
06805,Tigre,76,443,620,1063,edad 70
06805,Tigre,77,370,508,878,edad 70
06805,Tigre,78,364,549,913,edad 70
06805,Tigre,79,276,431,707,edad 70
06805,Tigre,80,244,424,668,edad 80
06805,Tigre,81,176,312,488,edad 80
06805,Tigre,82,177,309,486,edad 80
06805,Tigre,83,141,260,401,edad 80
06805,Tigre,84,107,243,350,edad 80
06805,Tigre,85,93,193,286,edad 80
06805,Tigre,86,84,175,259,edad 80
06805,Tigre,87,92,169,261,edad 80
06805,Tigre,88,49,132,181,edad 80
06805,Tigre,89,52,124,176,edad 80
06805,Tigre,90,37,99,136,edad 90
06805,Tigre,91,35,63,98,edad 90
06805,Tigre,92,21,60,81,edad 90
06805,Tigre,93,14,34,48,edad 90
06805,Tigre,94,9,38,47,edad 90
06805,Tigre,95,5,26,31,edad 90
06805,Tigre,96,7,18,25,edad 90
06805,Tigre,97,2,17,19,edad 90
06805,Tigre,98,0,11,11,edad 90
06805,Tigre,99,2,8,10,edad 90
06840,Tres de Febrero,0,2458,2317,4775,edad 0
06840,Tres de Febrero,1,2165,2109,4274,edad 0
06840,Tres de Febrero,2,2275,2327,4602,edad 0
06840,Tres de Febrero,3,2344,2336,4680,edad 0
06840,Tres de Febrero,4,2456,2243,4699,edad 0
06840,Tres de Febrero,5,2547,2381,4928,edad 0
06840,Tres de Febrero,6,2503,2409,4912,edad 0
06840,Tres de Febrero,7,2399,2315,4714,edad 0
06840,Tres de Febrero,8,2458,2319,4777,edad 0
06840,Tres de Febrero,9,2402,2306,4708,edad 0
06840,Tres de Febrero,10,2623,2618,5241,edad 10
06840,Tres de Febrero,11,2539,2537,5076,edad 10
06840,Tres de Febrero,12,2660,2498,5158,edad 10
06840,Tres de Febrero,13,2549,2543,5092,edad 10
06840,Tres de Febrero,14,2542,2532,5074,edad 10
06840,Tres de Febrero,15,2616,2505,5121,edad 10
06840,Tres de Febrero,16,2483,2455,4938,edad 10
06840,Tres de Febrero,17,2484,2487,4971,edad 10
06840,Tres de Febrero,18,2610,2519,5129,edad 10
06840,Tres de Febrero,19,2744,2665,5409,edad 10
06840,Tres de Febrero,20,2614,2772,5386,edad 20
06840,Tres de Febrero,21,2941,2890,5831,edad 20
06840,Tres de Febrero,22,2832,2718,5550,edad 20
06840,Tres de Febrero,23,2806,2930,5736,edad 20
06840,Tres de Febrero,24,2773,2952,5725,edad 20
06840,Tres de Febrero,25,2725,2807,5532,edad 20
06840,Tres de Febrero,26,2556,2621,5177,edad 20
06840,Tres de Febrero,27,2407,2492,4899,edad 20
06840,Tres de Febrero,28,2494,2505,4999,edad 20
06840,Tres de Febrero,29,2253,2287,4540,edad 20
06840,Tres de Febrero,30,2539,2517,5056,edad 30
06840,Tres de Febrero,31,2176,2216,4392,edad 30
06840,Tres de Febrero,32,2171,2244,4415,edad 30
06840,Tres de Febrero,33,2090,2154,4244,edad 30
06840,Tres de Febrero,34,2020,2079,4099,edad 30
06840,Tres de Febrero,35,2030,2136,4166,edad 30
06840,Tres de Febrero,36,1999,2117,4116,edad 30
06840,Tres de Febrero,37,1916,2116,4032,edad 30
06840,Tres de Febrero,38,2111,2254,4365,edad 30
06840,Tres de Febrero,39,2028,2161,4189,edad 30
06840,Tres de Febrero,40,2134,2366,4500,edad 40
06840,Tres de Febrero,41,2071,2099,4170,edad 40
06840,Tres de Febrero,42,2115,2326,4441,edad 40
06840,Tres de Febrero,43,2019,2177,4196,edad 40
06840,Tres de Febrero,44,1920,2183,4103,edad 40
06840,Tres de Febrero,45,2042,2336,4378,edad 40
06840,Tres de Febrero,46,1901,2274,4175,edad 40
06840,Tres de Febrero,47,1964,2166,4130,edad 40
06840,Tres de Febrero,48,1891,2163,4054,edad 40
06840,Tres de Febrero,49,1824,1961,3785,edad 40
06840,Tres de Febrero,50,2041,2340,4381,edad 50
06840,Tres de Febrero,51,1869,2065,3934,edad 50
06840,Tres de Febrero,52,1894,2207,4101,edad 50
06840,Tres de Febrero,53,1853,2034,3887,edad 50
06840,Tres de Febrero,54,1641,2025,3666,edad 50
06840,Tres de Febrero,55,1693,1933,3626,edad 50
06840,Tres de Febrero,56,1737,1952,3689,edad 50
06840,Tres de Febrero,57,1603,1732,3335,edad 50
06840,Tres de Febrero,58,1421,1735,3156,edad 50
06840,Tres de Febrero,59,1368,1603,2971,edad 50
06840,Tres de Febrero,60,1455,1808,3263,edad 60
06840,Tres de Febrero,61,1311,1683,2994,edad 60
06840,Tres de Febrero,62,1306,1673,2979,edad 60
06840,Tres de Febrero,63,1311,1704,3015,edad 60
06840,Tres de Febrero,64,1189,1591,2780,edad 60
06840,Tres de Febrero,65,1338,1733,3071,edad 60
06840,Tres de Febrero,66,1219,1550,2769,edad 60
06840,Tres de Febrero,67,1255,1631,2886,edad 60
06840,Tres de Febrero,68,1211,1677,2888,edad 60
06840,Tres de Febrero,69,1185,1669,2854,edad 60
06840,Tres de Febrero,70,1265,1826,3091,edad 70
06840,Tres de Febrero,71,1200,1616,2816,edad 70
06840,Tres de Febrero,72,1157,1573,2730,edad 70
06840,Tres de Febrero,73,1098,1548,2646,edad 70
06840,Tres de Febrero,74,989,1537,2526,edad 70
06840,Tres de Febrero,75,970,1443,2413,edad 70
06840,Tres de Febrero,76,879,1361,2240,edad 70
06840,Tres de Febrero,77,767,1226,1993,edad 70
06840,Tres de Febrero,78,716,1239,1955,edad 70
06840,Tres de Febrero,79,604,1018,1622,edad 70
06840,Tres de Febrero,80,582,1013,1595,edad 80
06840,Tres de Febrero,81,503,790,1293,edad 80
06840,Tres de Febrero,82,355,741,1096,edad 80
06840,Tres de Febrero,83,276,585,861,edad 80
06840,Tres de Febrero,84,257,576,833,edad 80
06840,Tres de Febrero,85,224,473,697,edad 80
06840,Tres de Febrero,86,190,495,685,edad 80
06840,Tres de Febrero,87,162,396,558,edad 80
06840,Tres de Febrero,88,121,300,421,edad 80
06840,Tres de Febrero,89,85,278,363,edad 80
06840,Tres de Febrero,90,72,232,304,edad 90
06840,Tres de Febrero,91,59,160,219,edad 90
06840,Tres de Febrero,92,38,127,165,edad 90
06840,Tres de Febrero,93,26,88,114,edad 90
06840,Tres de Febrero,94,19,90,109,edad 90
06840,Tres de Febrero,95,18,55,73,edad 90
06840,Tres de Febrero,96,10,41,51,edad 90
06840,Tres de Febrero,97,11,29,40,edad 90
06840,Tres de Febrero,98,3,17,20,edad 90
06840,Tres de Febrero,99,5,18,23,edad 90
06861,Vicente López,0,1683,1575,3258,edad 0
06861,Vicente López,1,1534,1510,3044,edad 0
06861,Vicente López,2,1619,1564,3183,edad 0
06861,Vicente López,3,1636,1566,3202,edad 0
06861,Vicente López,4,1611,1542,3153,edad 0
06861,Vicente López,5,1607,1539,3146,edad 0
06861,Vicente López,6,1609,1529,3138,edad 0
06861,Vicente López,7,1654,1531,3185,edad 0
06861,Vicente López,8,1674,1511,3185,edad 0
06861,Vicente López,9,1701,1600,3301,edad 0
06861,Vicente López,10,1724,1811,3535,edad 10
06861,Vicente López,11,1821,1737,3558,edad 10
06861,Vicente López,12,1830,1799,3629,edad 10
06861,Vicente López,13,1823,1674,3497,edad 10
06861,Vicente López,14,1957,1792,3749,edad 10
06861,Vicente López,15,1865,1798,3663,edad 10
06861,Vicente López,16,1948,1938,3886,edad 10
06861,Vicente López,17,1971,1924,3895,edad 10
06861,Vicente López,18,1993,2000,3993,edad 10
06861,Vicente López,19,2034,2009,4043,edad 10
06861,Vicente López,20,2054,2015,4069,edad 20
06861,Vicente López,21,2206,2338,4544,edad 20
06861,Vicente López,22,2238,2211,4449,edad 20
06861,Vicente López,23,2174,2210,4384,edad 20
06861,Vicente López,24,2235,2287,4522,edad 20
06861,Vicente López,25,2231,2223,4454,edad 20
06861,Vicente López,26,2067,2254,4321,edad 20
06861,Vicente López,27,2075,2049,4124,edad 20
06861,Vicente López,28,1924,2052,3976,edad 20
06861,Vicente López,29,1836,2068,3904,edad 20
06861,Vicente López,30,1936,2048,3984,edad 30
06861,Vicente López,31,1723,1980,3703,edad 30
06861,Vicente López,32,1726,1847,3573,edad 30
06861,Vicente López,33,1711,1840,3551,edad 30
06861,Vicente López,34,1591,1738,3329,edad 30
06861,Vicente López,35,1600,1811,3411,edad 30
06861,Vicente López,36,1675,1921,3596,edad 30
06861,Vicente López,37,1622,1882,3504,edad 30
06861,Vicente López,38,1733,1938,3671,edad 30
06861,Vicente López,39,1752,1765,3517,edad 30
06861,Vicente López,40,1713,2081,3794,edad 40
06861,Vicente López,41,1702,1939,3641,edad 40
06861,Vicente López,42,1750,1977,3727,edad 40
06861,Vicente López,43,1631,1854,3485,edad 40
06861,Vicente López,44,1608,1737,3345,edad 40
06861,Vicente López,45,1614,1877,3491,edad 40
06861,Vicente López,46,1608,1861,3469,edad 40
06861,Vicente López,47,1510,1772,3282,edad 40
06861,Vicente López,48,1565,1823,3388,edad 40
06861,Vicente López,49,1508,1820,3328,edad 40
06861,Vicente López,50,1682,2105,3787,edad 50
06861,Vicente López,51,1548,1911,3459,edad 50
06861,Vicente López,52,1645,1930,3575,edad 50
06861,Vicente López,53,1533,1851,3384,edad 50
06861,Vicente López,54,1412,1758,3170,edad 50
06861,Vicente López,55,1520,1804,3324,edad 50
06861,Vicente López,56,1536,1916,3452,edad 50
06861,Vicente López,57,1339,1646,2985,edad 50
06861,Vicente López,58,1300,1588,2888,edad 50
06861,Vicente López,59,1155,1459,2614,edad 50
06861,Vicente López,60,1262,1751,3013,edad 60
06861,Vicente López,61,1165,1434,2599,edad 60
06861,Vicente López,62,1124,1529,2653,edad 60
06861,Vicente López,63,1127,1460,2587,edad 60
06861,Vicente López,64,1028,1335,2363,edad 60
06861,Vicente López,65,1133,1527,2660,edad 60
06861,Vicente López,66,1016,1424,2440,edad 60
06861,Vicente López,67,1016,1338,2354,edad 60
06861,Vicente López,68,996,1432,2428,edad 60
06861,Vicente López,69,1049,1380,2429,edad 60
06861,Vicente López,70,1102,1663,2765,edad 70
06861,Vicente López,71,1010,1425,2435,edad 70
06861,Vicente López,72,1011,1533,2544,edad 70
06861,Vicente López,73,938,1374,2312,edad 70
06861,Vicente López,74,890,1353,2243,edad 70
06861,Vicente López,75,899,1373,2272,edad 70
06861,Vicente López,76,799,1293,2092,edad 70
06861,Vicente López,77,712,1248,1960,edad 70
06861,Vicente López,78,724,1155,1879,edad 70
06861,Vicente López,79,577,1000,1577,edad 70
06861,Vicente López,80,574,1065,1639,edad 80
06861,Vicente López,81,460,820,1280,edad 80
06861,Vicente López,82,419,792,1211,edad 80
06861,Vicente López,83,307,675,982,edad 80
06861,Vicente López,84,289,608,897,edad 80
06861,Vicente López,85,266,591,857,edad 80
06861,Vicente López,86,233,555,788,edad 80
06861,Vicente López,87,186,500,686,edad 80
06861,Vicente López,88,164,432,596,edad 80
06861,Vicente López,89,115,352,467,edad 80
06861,Vicente López,90,108,316,424,edad 90
06861,Vicente López,91,75,238,313,edad 90
06861,Vicente López,92,60,205,265,edad 90
06861,Vicente López,93,41,153,194,edad 90
06861,Vicente López,94,29,116,145,edad 90
06861,Vicente López,95,19,86,105,edad 90
06861,Vicente López,96,14,75,89,edad 90
06861,Vicente López,97,6,41,47,edad 90
06861,Vicente López,98,5,24,29,edad 90
06861,Vicente López,99,6,22,28,edad 90
06007,Adolfo Alsina,0,129,120,249,edad 0
06007,Adolfo Alsina,1,111,109,220,edad 0
06007,Adolfo Alsina,2,135,111,246,edad 0
06007,Adolfo Alsina,3,151,124,275,edad 0
06007,Adolfo Alsina,4,121,125,246,edad 0
06007,Adolfo Alsina,5,143,118,261,edad 0
06007,Adolfo Alsina,6,152,114,266,edad 0
06007,Adolfo Alsina,7,137,143,280,edad 0
06007,Adolfo Alsina,8,133,135,268,edad 0
06007,Adolfo Alsina,9,137,151,288,edad 0
06007,Adolfo Alsina,10,153,153,306,edad 10
06007,Adolfo Alsina,11,120,154,274,edad 10
06007,Adolfo Alsina,12,166,139,305,edad 10
06007,Adolfo Alsina,13,141,151,292,edad 10
06007,Adolfo Alsina,14,146,137,283,edad 10
06007,Adolfo Alsina,15,134,135,269,edad 10
06007,Adolfo Alsina,16,137,136,273,edad 10
06007,Adolfo Alsina,17,157,139,296,edad 10
06007,Adolfo Alsina,18,115,103,218,edad 10
06007,Adolfo Alsina,19,102,102,204,edad 10
06007,Adolfo Alsina,20,95,97,192,edad 20
06007,Adolfo Alsina,21,110,104,214,edad 20
06007,Adolfo Alsina,22,97,91,188,edad 20
06007,Adolfo Alsina,23,84,109,193,edad 20
06007,Adolfo Alsina,24,100,93,193,edad 20
06007,Adolfo Alsina,25,96,94,190,edad 20
06007,Adolfo Alsina,26,111,104,215,edad 20
06007,Adolfo Alsina,27,90,97,187,edad 20
06007,Adolfo Alsina,28,97,93,190,edad 20
06007,Adolfo Alsina,29,101,97,198,edad 20
06007,Adolfo Alsina,30,101,115,216,edad 30
06007,Adolfo Alsina,31,97,102,199,edad 30
06007,Adolfo Alsina,32,103,103,206,edad 30
06007,Adolfo Alsina,33,102,94,196,edad 30
06007,Adolfo Alsina,34,93,85,178,edad 30
06007,Adolfo Alsina,35,119,102,221,edad 30
06007,Adolfo Alsina,36,91,121,212,edad 30
06007,Adolfo Alsina,37,112,105,217,edad 30
06007,Adolfo Alsina,38,126,108,234,edad 30
06007,Adolfo Alsina,39,99,111,210,edad 30
06007,Adolfo Alsina,40,105,108,213,edad 40
06007,Adolfo Alsina,41,97,98,195,edad 40
06007,Adolfo Alsina,42,98,108,206,edad 40
06007,Adolfo Alsina,43,106,103,209,edad 40
06007,Adolfo Alsina,44,99,95,194,edad 40
06007,Adolfo Alsina,45,108,89,197,edad 40
06007,Adolfo Alsina,46,109,95,204,edad 40
06007,Adolfo Alsina,47,96,93,189,edad 40
06007,Adolfo Alsina,48,101,87,188,edad 40
06007,Adolfo Alsina,49,85,101,186,edad 40
06007,Adolfo Alsina,50,119,83,202,edad 50
06007,Adolfo Alsina,51,101,96,197,edad 50
06007,Adolfo Alsina,52,89,93,182,edad 50
06007,Adolfo Alsina,53,98,85,183,edad 50
06007,Adolfo Alsina,54,98,81,179,edad 50
06007,Adolfo Alsina,55,87,97,184,edad 50
06007,Adolfo Alsina,56,109,102,211,edad 50
06007,Adolfo Alsina,57,74,71,145,edad 50
06007,Adolfo Alsina,58,76,73,149,edad 50
06007,Adolfo Alsina,59,84,82,166,edad 50
06007,Adolfo Alsina,60,81,91,172,edad 60
06007,Adolfo Alsina,61,82,77,159,edad 60
06007,Adolfo Alsina,62,85,70,155,edad 60
06007,Adolfo Alsina,63,78,93,171,edad 60
06007,Adolfo Alsina,64,68,80,148,edad 60
06007,Adolfo Alsina,65,86,80,166,edad 60
06007,Adolfo Alsina,66,72,72,144,edad 60
06007,Adolfo Alsina,67,70,85,155,edad 60
06007,Adolfo Alsina,68,80,69,149,edad 60
06007,Adolfo Alsina,69,66,75,141,edad 60
06007,Adolfo Alsina,70,76,72,148,edad 70
06007,Adolfo Alsina,71,68,66,134,edad 70
06007,Adolfo Alsina,72,37,66,103,edad 70
06007,Adolfo Alsina,73,59,68,127,edad 70
06007,Adolfo Alsina,74,53,49,102,edad 70
06007,Adolfo Alsina,75,38,60,98,edad 70
06007,Adolfo Alsina,76,50,60,110,edad 70
06007,Adolfo Alsina,77,23,56,79,edad 70
06007,Adolfo Alsina,78,35,42,77,edad 70
06007,Adolfo Alsina,79,29,26,55,edad 70
06007,Adolfo Alsina,80,23,35,58,edad 80
06007,Adolfo Alsina,81,27,42,69,edad 80
06007,Adolfo Alsina,82,19,29,48,edad 80
06007,Adolfo Alsina,83,14,46,60,edad 80
06007,Adolfo Alsina,84,18,45,63,edad 80
06007,Adolfo Alsina,85,12,26,38,edad 80
06007,Adolfo Alsina,86,12,20,32,edad 80
06007,Adolfo Alsina,87,12,24,36,edad 80
06007,Adolfo Alsina,88,6,17,23,edad 80
06007,Adolfo Alsina,89,11,15,26,edad 80
06007,Adolfo Alsina,90,1,8,9,edad 90
06007,Adolfo Alsina,91,4,12,16,edad 90
06007,Adolfo Alsina,92,2,4,6,edad 90
06007,Adolfo Alsina,93,2,5,7,edad 90
06007,Adolfo Alsina,94,0,4,4,edad 90
06007,Adolfo Alsina,95,2,1,3,edad 90
06007,Adolfo Alsina,96,1,2,3,edad 90
06007,Adolfo Alsina,97,1,0,1,edad 90
06007,Adolfo Alsina,98,1,0,1,edad 90
06014,Adolfo Gonzáles Chaves,0,94,100,194,edad 0
06014,Adolfo Gonzáles Chaves,1,95,92,187,edad 0
06014,Adolfo Gonzáles Chaves,2,109,103,212,edad 0
06014,Adolfo Gonzáles Chaves,3,84,89,173,edad 0
06014,Adolfo Gonzáles Chaves,4,106,95,201,edad 0
06014,Adolfo Gonzáles Chaves,5,110,93,203,edad 0
06014,Adolfo Gonzáles Chaves,6,98,76,174,edad 0
06014,Adolfo Gonzáles Chaves,7,125,109,234,edad 0
06014,Adolfo Gonzáles Chaves,8,129,89,218,edad 0
06014,Adolfo Gonzáles Chaves,9,119,130,249,edad 0
06014,Adolfo Gonzáles Chaves,10,120,110,230,edad 10
06014,Adolfo Gonzáles Chaves,11,121,105,226,edad 10
06014,Adolfo Gonzáles Chaves,12,106,93,199,edad 10
06014,Adolfo Gonzáles Chaves,13,99,115,214,edad 10
06014,Adolfo Gonzáles Chaves,14,103,93,196,edad 10
06014,Adolfo Gonzáles Chaves,15,136,103,239,edad 10
06014,Adolfo Gonzáles Chaves,16,110,87,197,edad 10
06014,Adolfo Gonzáles Chaves,17,97,110,207,edad 10
06014,Adolfo Gonzáles Chaves,18,89,67,156,edad 10
06014,Adolfo Gonzáles Chaves,19,89,79,168,edad 10
06014,Adolfo Gonzáles Chaves,20,91,92,183,edad 20
06014,Adolfo Gonzáles Chaves,21,90,62,152,edad 20
06014,Adolfo Gonzáles Chaves,22,89,76,165,edad 20
06014,Adolfo Gonzáles Chaves,23,72,91,163,edad 20
06014,Adolfo Gonzáles Chaves,24,84,79,163,edad 20
06014,Adolfo Gonzáles Chaves,25,87,75,162,edad 20
06014,Adolfo Gonzáles Chaves,26,57,85,142,edad 20
06014,Adolfo Gonzáles Chaves,27,89,64,153,edad 20
06014,Adolfo Gonzáles Chaves,28,61,71,132,edad 20
06014,Adolfo Gonzáles Chaves,29,60,81,141,edad 20
06014,Adolfo Gonzáles Chaves,30,69,76,145,edad 30
06014,Adolfo Gonzáles Chaves,31,63,54,117,edad 30
06014,Adolfo Gonzáles Chaves,32,73,72,145,edad 30
06014,Adolfo Gonzáles Chaves,33,73,78,151,edad 30
06014,Adolfo Gonzáles Chaves,34,70,61,131,edad 30
06014,Adolfo Gonzáles Chaves,35,59,65,124,edad 30
06014,Adolfo Gonzáles Chaves,36,61,78,139,edad 30
06014,Adolfo Gonzáles Chaves,37,78,74,152,edad 30
06014,Adolfo Gonzáles Chaves,38,68,63,131,edad 30
06014,Adolfo Gonzáles Chaves,39,69,79,148,edad 30
06014,Adolfo Gonzáles Chaves,40,72,87,159,edad 40
06014,Adolfo Gonzáles Chaves,41,76,73,149,edad 40
06014,Adolfo Gonzáles Chaves,42,70,85,155,edad 40
06014,Adolfo Gonzáles Chaves,43,69,68,137,edad 40
06014,Adolfo Gonzáles Chaves,44,86,73,159,edad 40
06014,Adolfo Gonzáles Chaves,45,58,59,117,edad 40
06014,Adolfo Gonzáles Chaves,46,63,86,149,edad 40
06014,Adolfo Gonzáles Chaves,47,61,72,133,edad 40
06014,Adolfo Gonzáles Chaves,48,65,66,131,edad 40
06014,Adolfo Gonzáles Chaves,49,70,50,120,edad 40
06014,Adolfo Gonzáles Chaves,50,64,82,146,edad 50
06014,Adolfo Gonzáles Chaves,51,67,68,135,edad 50
06014,Adolfo Gonzáles Chaves,52,72,71,143,edad 50
06014,Adolfo Gonzáles Chaves,53,72,67,139,edad 50
06014,Adolfo Gonzáles Chaves,54,69,73,142,edad 50
06014,Adolfo Gonzáles Chaves,55,55,76,131,edad 50
06014,Adolfo Gonzáles Chaves,56,72,70,142,edad 50
06014,Adolfo Gonzáles Chaves,57,54,54,108,edad 50
06014,Adolfo Gonzáles Chaves,58,56,54,110,edad 50
06014,Adolfo Gonzáles Chaves,59,41,53,94,edad 50
06014,Adolfo Gonzáles Chaves,60,50,48,98,edad 60
06014,Adolfo Gonzáles Chaves,61,49,55,104,edad 60
06014,Adolfo Gonzáles Chaves,62,43,62,105,edad 60
06014,Adolfo Gonzáles Chaves,63,66,54,120,edad 60
06014,Adolfo Gonzáles Chaves,64,45,49,94,edad 60
06014,Adolfo Gonzáles Chaves,65,47,58,105,edad 60
06014,Adolfo Gonzáles Chaves,66,45,46,91,edad 60
06014,Adolfo Gonzáles Chaves,67,35,43,78,edad 60
06014,Adolfo Gonzáles Chaves,68,54,57,111,edad 60
06014,Adolfo Gonzáles Chaves,69,45,53,98,edad 60
06014,Adolfo Gonzáles Chaves,70,45,74,119,edad 70
06014,Adolfo Gonzáles Chaves,71,39,43,82,edad 70
06014,Adolfo Gonzáles Chaves,72,43,55,98,edad 70
06014,Adolfo Gonzáles Chaves,73,39,50,89,edad 70
06014,Adolfo Gonzáles Chaves,74,58,66,124,edad 70
06014,Adolfo Gonzáles Chaves,75,33,54,87,edad 70
06014,Adolfo Gonzáles Chaves,76,30,39,69,edad 70
06014,Adolfo Gonzáles Chaves,77,27,43,70,edad 70
06014,Adolfo Gonzáles Chaves,78,36,47,83,edad 70
06014,Adolfo Gonzáles Chaves,79,29,39,68,edad 70
06014,Adolfo Gonzáles Chaves,80,24,35,59,edad 80
06014,Adolfo Gonzáles Chaves,81,17,39,56,edad 80
06014,Adolfo Gonzáles Chaves,82,15,28,43,edad 80
06014,Adolfo Gonzáles Chaves,83,20,31,51,edad 80
06014,Adolfo Gonzáles Chaves,84,13,29,42,edad 80
06014,Adolfo Gonzáles Chaves,85,7,27,34,edad 80
06014,Adolfo Gonzáles Chaves,86,11,14,25,edad 80
06014,Adolfo Gonzáles Chaves,87,12,23,35,edad 80
06014,Adolfo Gonzáles Chaves,88,7,20,27,edad 80
06014,Adolfo Gonzáles Chaves,89,5,6,11,edad 80
06014,Adolfo Gonzáles Chaves,90,6,5,11,edad 90
06014,Adolfo Gonzáles Chaves,91,3,8,11,edad 90
06014,Adolfo Gonzáles Chaves,92,3,1,4,edad 90
06014,Adolfo Gonzáles Chaves,93,2,7,9,edad 90
06014,Adolfo Gonzáles Chaves,94,1,5,6,edad 90
06014,Adolfo Gonzáles Chaves,95,0,1,1,edad 90
06014,Adolfo Gonzáles Chaves,98,0,1,1,edad 90
06014,Adolfo Gonzáles Chaves,99,2,1,3,edad 90
06021,Alberti,0,52,73,125,edad 0
06021,Alberti,1,77,62,139,edad 0
06021,Alberti,2,79,62,141,edad 0
06021,Alberti,3,81,66,147,edad 0
06021,Alberti,4,66,63,129,edad 0
06021,Alberti,5,75,59,134,edad 0
06021,Alberti,6,75,78,153,edad 0
06021,Alberti,7,76,58,134,edad 0
06021,Alberti,8,59,69,128,edad 0
06021,Alberti,9,75,85,160,edad 0
06021,Alberti,10,91,92,183,edad 10
06021,Alberti,11,90,79,169,edad 10
06021,Alberti,12,94,70,164,edad 10
06021,Alberti,13,74,84,158,edad 10
06021,Alberti,14,79,94,173,edad 10
06021,Alberti,15,89,66,155,edad 10
06021,Alberti,16,68,68,136,edad 10
06021,Alberti,17,74,75,149,edad 10
06021,Alberti,18,84,63,147,edad 10
06021,Alberti,19,74,79,153,edad 10
06021,Alberti,20,68,66,134,edad 20
06021,Alberti,21,88,78,166,edad 20
06021,Alberti,22,71,68,139,edad 20
06021,Alberti,23,69,80,149,edad 20
06021,Alberti,24,80,65,145,edad 20
06021,Alberti,25,82,71,153,edad 20
06021,Alberti,26,58,60,118,edad 20
06021,Alberti,27,62,69,131,edad 20
06021,Alberti,28,68,50,118,edad 20
06021,Alberti,29,67,54,121,edad 20
06021,Alberti,30,63,52,115,edad 30
06021,Alberti,31,54,56,110,edad 30
06021,Alberti,32,56,46,102,edad 30
06021,Alberti,33,53,60,113,edad 30
06021,Alberti,34,50,48,98,edad 30
06021,Alberti,35,52,72,124,edad 30
06021,Alberti,36,47,65,112,edad 30
06021,Alberti,37,48,60,108,edad 30
06021,Alberti,38,66,63,129,edad 30
06021,Alberti,39,53,73,126,edad 30
06021,Alberti,40,63,77,140,edad 40
06021,Alberti,41,74,79,153,edad 40
06021,Alberti,42,63,59,122,edad 40
06021,Alberti,43,53,71,124,edad 40
06021,Alberti,44,81,63,144,edad 40
06021,Alberti,45,70,76,146,edad 40
06021,Alberti,46,74,66,140,edad 40
06021,Alberti,47,62,59,121,edad 40
06021,Alberti,48,57,63,120,edad 40
06021,Alberti,49,69,76,145,edad 40
06021,Alberti,50,77,58,135,edad 50
06021,Alberti,51,58,74,132,edad 50
06021,Alberti,52,55,65,120,edad 50
06021,Alberti,53,61,58,119,edad 50
06021,Alberti,54,61,61,122,edad 50
06021,Alberti,55,60,66,126,edad 50
06021,Alberti,56,59,73,132,edad 50
06021,Alberti,57,65,40,105,edad 50
06021,Alberti,58,44,46,90,edad 50
06021,Alberti,59,50,55,105,edad 50
06021,Alberti,60,61,58,119,edad 60
06021,Alberti,61,45,55,100,edad 60
06021,Alberti,62,62,65,127,edad 60
06021,Alberti,63,56,63,119,edad 60
06021,Alberti,64,50,51,101,edad 60
06021,Alberti,65,48,64,112,edad 60
06021,Alberti,66,42,46,88,edad 60
06021,Alberti,67,43,46,89,edad 60
06021,Alberti,68,40,55,95,edad 60
06021,Alberti,69,43,51,94,edad 60
06021,Alberti,70,56,46,102,edad 70
06021,Alberti,71,36,51,87,edad 70
06021,Alberti,72,30,73,103,edad 70
06021,Alberti,73,40,67,107,edad 70
06021,Alberti,74,38,48,86,edad 70
06021,Alberti,75,35,63,98,edad 70
06021,Alberti,76,26,35,61,edad 70
06021,Alberti,77,39,36,75,edad 70
06021,Alberti,78,26,43,69,edad 70
06021,Alberti,79,24,37,61,edad 70
06021,Alberti,80,27,38,65,edad 80
06021,Alberti,81,16,35,51,edad 80
06021,Alberti,82,18,36,54,edad 80
06021,Alberti,83,14,32,46,edad 80
06021,Alberti,84,15,31,46,edad 80
06021,Alberti,85,7,25,32,edad 80
06021,Alberti,86,10,22,32,edad 80
06021,Alberti,87,9,19,28,edad 80
06021,Alberti,88,5,14,19,edad 80
06021,Alberti,89,3,11,14,edad 80
06021,Alberti,90,4,11,15,edad 90
06021,Alberti,91,4,11,15,edad 90
06021,Alberti,92,1,10,11,edad 90
06021,Alberti,93,1,3,4,edad 90
06021,Alberti,94,2,3,5,edad 90
06021,Alberti,95,1,4,5,edad 90
06021,Alberti,96,1,2,3,edad 90
06021,Alberti,97,2,1,3,edad 90
06021,Alberti,98,1,1,2,edad 90
06021,Alberti,99,1,0,1,edad 90
06042,Ayacucho,0,171,160,331,edad 0
06042,Ayacucho,1,144,140,284,edad 0
06042,Ayacucho,2,185,166,351,edad 0
06042,Ayacucho,3,186,156,342,edad 0
06042,Ayacucho,4,185,141,326,edad 0
06042,Ayacucho,5,179,166,345,edad 0
06042,Ayacucho,6,184,166,350,edad 0
06042,Ayacucho,7,160,163,323,edad 0
06042,Ayacucho,8,181,161,342,edad 0
06042,Ayacucho,9,192,183,375,edad 0
06042,Ayacucho,10,197,181,378,edad 10
06042,Ayacucho,11,194,185,379,edad 10
06042,Ayacucho,12,180,172,352,edad 10
06042,Ayacucho,13,181,169,350,edad 10
06042,Ayacucho,14,192,194,386,edad 10
06042,Ayacucho,15,197,174,371,edad 10
06042,Ayacucho,16,185,183,368,edad 10
06042,Ayacucho,17,154,168,322,edad 10
06042,Ayacucho,18,189,166,355,edad 10
06042,Ayacucho,19,163,150,313,edad 10
06042,Ayacucho,20,143,167,310,edad 20
06042,Ayacucho,21,155,149,304,edad 20
06042,Ayacucho,22,142,141,283,edad 20
06042,Ayacucho,23,131,131,262,edad 20
06042,Ayacucho,24,135,135,270,edad 20
06042,Ayacucho,25,130,103,233,edad 20
06042,Ayacucho,26,102,122,224,edad 20
06042,Ayacucho,27,129,139,268,edad 20
06042,Ayacucho,28,117,126,243,edad 20
06042,Ayacucho,29,116,112,228,edad 20
06042,Ayacucho,30,125,118,243,edad 30
06042,Ayacucho,31,102,122,224,edad 30
06042,Ayacucho,32,106,120,226,edad 30
06042,Ayacucho,33,104,114,218,edad 30
06042,Ayacucho,34,107,110,217,edad 30
06042,Ayacucho,35,103,135,238,edad 30
06042,Ayacucho,36,115,127,242,edad 30
06042,Ayacucho,37,124,127,251,edad 30
06042,Ayacucho,38,125,130,255,edad 30
06042,Ayacucho,39,121,109,230,edad 30
06042,Ayacucho,40,117,115,232,edad 40
06042,Ayacucho,41,109,124,233,edad 40
06042,Ayacucho,42,103,123,226,edad 40
06042,Ayacucho,43,99,107,206,edad 40
06042,Ayacucho,44,102,110,212,edad 40
06042,Ayacucho,45,124,109,233,edad 40
06042,Ayacucho,46,87,89,176,edad 40
06042,Ayacucho,47,119,102,221,edad 40
06042,Ayacucho,48,97,122,219,edad 40
06042,Ayacucho,49,106,98,204,edad 40
06042,Ayacucho,50,117,103,220,edad 50
06042,Ayacucho,51,107,118,225,edad 50
06042,Ayacucho,52,103,114,217,edad 50
06042,Ayacucho,53,109,115,224,edad 50
06042,Ayacucho,54,105,101,206,edad 50
06042,Ayacucho,55,101,111,212,edad 50
06042,Ayacucho,56,114,101,215,edad 50
06042,Ayacucho,57,110,90,200,edad 50
06042,Ayacucho,58,91,106,197,edad 50
06042,Ayacucho,59,82,97,179,edad 50
06042,Ayacucho,60,95,89,184,edad 60
06042,Ayacucho,61,87,80,167,edad 60
06042,Ayacucho,62,71,89,160,edad 60
06042,Ayacucho,63,84,88,172,edad 60
06042,Ayacucho,64,75,85,160,edad 60
06042,Ayacucho,65,71,84,155,edad 60
06042,Ayacucho,66,76,68,144,edad 60
06042,Ayacucho,67,65,82,147,edad 60
06042,Ayacucho,68,75,67,142,edad 60
06042,Ayacucho,69,71,83,154,edad 60
06042,Ayacucho,70,57,63,120,edad 70
06042,Ayacucho,71,59,78,137,edad 70
06042,Ayacucho,72,59,67,126,edad 70
06042,Ayacucho,73,62,80,142,edad 70
06042,Ayacucho,74,53,74,127,edad 70
06042,Ayacucho,75,49,74,123,edad 70
06042,Ayacucho,76,46,69,115,edad 70
06042,Ayacucho,77,41,59,100,edad 70
06042,Ayacucho,78,34,89,123,edad 70
06042,Ayacucho,79,35,63,98,edad 70
06042,Ayacucho,80,41,55,96,edad 80
06042,Ayacucho,81,31,54,85,edad 80
06042,Ayacucho,82,25,42,67,edad 80
06042,Ayacucho,83,29,39,68,edad 80
06042,Ayacucho,84,15,46,61,edad 80
06042,Ayacucho,85,21,35,56,edad 80
06042,Ayacucho,86,15,44,59,edad 80
06042,Ayacucho,87,20,23,43,edad 80
06042,Ayacucho,88,6,30,36,edad 80
06042,Ayacucho,89,6,24,30,edad 80
06042,Ayacucho,90,11,15,26,edad 90
06042,Ayacucho,91,3,21,24,edad 90
06042,Ayacucho,92,3,9,12,edad 90
06042,Ayacucho,93,2,9,11,edad 90
06042,Ayacucho,94,3,9,12,edad 90
06042,Ayacucho,95,2,6,8,edad 90
06042,Ayacucho,96,1,5,6,edad 90
06042,Ayacucho,97,1,2,3,edad 90
06042,Ayacucho,99,0,1,1,edad 90
06049,Azul,0,534,528,1062,edad 0
06049,Azul,1,492,471,963,edad 0
06049,Azul,2,513,537,1050,edad 0
06049,Azul,3,543,512,1055,edad 0
06049,Azul,4,525,549,1074,edad 0
06049,Azul,5,557,531,1088,edad 0
06049,Azul,6,561,519,1080,edad 0
06049,Azul,7,537,535,1072,edad 0
06049,Azul,8,535,522,1057,edad 0
06049,Azul,9,539,519,1058,edad 0
06049,Azul,10,515,599,1114,edad 10
06049,Azul,11,567,519,1086,edad 10
06049,Azul,12,514,514,1028,edad 10
06049,Azul,13,531,524,1055,edad 10
06049,Azul,14,499,478,977,edad 10
06049,Azul,15,564,500,1064,edad 10
06049,Azul,16,520,481,1001,edad 10
06049,Azul,17,529,509,1038,edad 10
06049,Azul,18,497,439,936,edad 10
06049,Azul,19,472,445,917,edad 10
06049,Azul,20,454,448,902,edad 20
06049,Azul,21,486,440,926,edad 20
06049,Azul,22,509,442,951,edad 20
06049,Azul,23,487,463,950,edad 20
06049,Azul,24,488,459,947,edad 20
06049,Azul,25,469,420,889,edad 20
06049,Azul,26,472,444,916,edad 20
06049,Azul,27,412,437,849,edad 20
06049,Azul,28,418,436,854,edad 20
06049,Azul,29,408,393,801,edad 20
06049,Azul,30,413,391,804,edad 30
06049,Azul,31,414,417,831,edad 30
06049,Azul,32,371,402,773,edad 30
06049,Azul,33,392,373,765,edad 30
06049,Azul,34,362,362,724,edad 30
06049,Azul,35,362,427,789,edad 30
06049,Azul,36,425,379,804,edad 30
06049,Azul,37,368,398,766,edad 30
06049,Azul,38,387,404,791,edad 30
06049,Azul,39,352,363,715,edad 30
06049,Azul,40,373,393,766,edad 40
06049,Azul,41,368,348,716,edad 40
06049,Azul,42,378,423,801,edad 40
06049,Azul,43,367,376,743,edad 40
06049,Azul,44,309,351,660,edad 40
06049,Azul,45,340,368,708,edad 40
06049,Azul,46,341,343,684,edad 40
06049,Azul,47,363,390,753,edad 40
06049,Azul,48,335,410,745,edad 40
06049,Azul,49,337,355,692,edad 40
06049,Azul,50,371,406,777,edad 50
06049,Azul,51,350,389,739,edad 50
06049,Azul,52,351,409,760,edad 50
06049,Azul,53,402,386,788,edad 50
06049,Azul,54,339,407,746,edad 50
06049,Azul,55,316,356,672,edad 50
06049,Azul,56,399,374,773,edad 50
06049,Azul,57,311,329,640,edad 50
06049,Azul,58,344,296,640,edad 50
06049,Azul,59,273,298,571,edad 50
06049,Azul,60,299,304,603,edad 60
06049,Azul,61,251,258,509,edad 60
06049,Azul,62,295,308,603,edad 60
06049,Azul,63,223,262,485,edad 60
06049,Azul,64,250,265,515,edad 60
06049,Azul,65,227,271,498,edad 60
06049,Azul,66,194,262,456,edad 60
06049,Azul,67,199,257,456,edad 60
06049,Azul,68,199,246,445,edad 60
06049,Azul,69,204,265,469,edad 60
06049,Azul,70,227,285,512,edad 70
06049,Azul,71,198,298,496,edad 70
06049,Azul,72,208,270,478,edad 70
06049,Azul,73,184,260,444,edad 70
06049,Azul,74,171,221,392,edad 70
06049,Azul,75,166,226,392,edad 70
06049,Azul,76,148,225,373,edad 70
06049,Azul,77,125,223,348,edad 70
06049,Azul,78,108,219,327,edad 70
06049,Azul,79,104,172,276,edad 70
06049,Azul,80,114,206,320,edad 80
06049,Azul,81,84,172,256,edad 80
06049,Azul,82,79,136,215,edad 80
06049,Azul,83,50,137,187,edad 80
06049,Azul,84,44,124,168,edad 80
06049,Azul,85,42,105,147,edad 80
06049,Azul,86,34,107,141,edad 80
06049,Azul,87,39,101,140,edad 80
06049,Azul,88,36,62,98,edad 80
06049,Azul,89,22,65,87,edad 80
06049,Azul,90,19,48,67,edad 90
06049,Azul,91,11,40,51,edad 90
06049,Azul,92,7,26,33,edad 90
06049,Azul,93,8,22,30,edad 90
06049,Azul,94,3,20,23,edad 90
06049,Azul,95,5,20,25,edad 90
06049,Azul,96,4,8,12,edad 90
06049,Azul,97,3,7,10,edad 90
06049,Azul,98,1,0,1,edad 90
06049,Azul,99,3,3,6,edad 90
06056,Bahía Blanca,0,2190,2189,4379,edad 0
06056,Bahía Blanca,1,2061,1936,3997,edad 0
06056,Bahía Blanca,2,2177,2068,4245,edad 0
06056,Bahía Blanca,3,2082,2039,4121,edad 0
06056,Bahía Blanca,4,2197,2054,4251,edad 0
06056,Bahía Blanca,5,2172,2088,4260,edad 0
06056,Bahía Blanca,6,2184,2165,4349,edad 0
06056,Bahía Blanca,7,2238,2126,4364,edad 0
06056,Bahía Blanca,8,2264,2128,4392,edad 0
06056,Bahía Blanca,9,2426,2242,4668,edad 0
06056,Bahía Blanca,10,2553,2512,5065,edad 10
06056,Bahía Blanca,11,2619,2426,5045,edad 10
06056,Bahía Blanca,12,2414,2362,4776,edad 10
06056,Bahía Blanca,13,2496,2436,4932,edad 10
06056,Bahía Blanca,14,2562,2446,5008,edad 10
06056,Bahía Blanca,15,2576,2476,5052,edad 10
06056,Bahía Blanca,16,2528,2468,4996,edad 10
06056,Bahía Blanca,17,2521,2331,4852,edad 10
06056,Bahía Blanca,18,2490,2536,5026,edad 10
06056,Bahía Blanca,19,2600,2696,5296,edad 10
06056,Bahía Blanca,20,2746,2639,5385,edad 20
06056,Bahía Blanca,21,2800,2669,5469,edad 20
06056,Bahía Blanca,22,2692,2613,5305,edad 20
06056,Bahía Blanca,23,2608,2601,5209,edad 20
06056,Bahía Blanca,24,2466,2466,4932,edad 20
06056,Bahía Blanca,25,2252,2279,4531,edad 20
06056,Bahía Blanca,26,2259,2142,4401,edad 20
06056,Bahía Blanca,27,2016,2034,4050,edad 20
06056,Bahía Blanca,28,1960,1997,3957,edad 20
06056,Bahía Blanca,29,1889,1939,3828,edad 20
06056,Bahía Blanca,30,2009,1967,3976,edad 30
06056,Bahía Blanca,31,1763,1731,3494,edad 30
06056,Bahía Blanca,32,1719,1850,3569,edad 30
06056,Bahía Blanca,33,1795,1766,3561,edad 30
06056,Bahía Blanca,34,1621,1743,3364,edad 30
06056,Bahía Blanca,35,1611,1745,3356,edad 30
06056,Bahía Blanca,36,1699,1864,3563,edad 30
06056,Bahía Blanca,37,1658,1782,3440,edad 30
06056,Bahía Blanca,38,1762,1912,3674,edad 30
06056,Bahía Blanca,39,1657,1831,3488,edad 30
06056,Bahía Blanca,40,1768,1879,3647,edad 40
06056,Bahía Blanca,41,1739,1804,3543,edad 40
06056,Bahía Blanca,42,1689,1760,3449,edad 40
06056,Bahía Blanca,43,1492,1774,3266,edad 40
06056,Bahía Blanca,44,1501,1634,3135,edad 40
06056,Bahía Blanca,45,1614,1781,3395,edad 40
06056,Bahía Blanca,46,1523,1679,3202,edad 40
06056,Bahía Blanca,47,1551,1677,3228,edad 40
06056,Bahía Blanca,48,1514,1685,3199,edad 40
06056,Bahía Blanca,49,1397,1599,2996,edad 40
06056,Bahía Blanca,50,1555,1730,3285,edad 50
06056,Bahía Blanca,51,1482,1634,3116,edad 50
06056,Bahía Blanca,52,1548,1674,3222,edad 50
06056,Bahía Blanca,53,1407,1603,3010,edad 50
06056,Bahía Blanca,54,1397,1639,3036,edad 50
06056,Bahía Blanca,55,1325,1482,2807,edad 50
06056,Bahía Blanca,56,1453,1549,3002,edad 50
06056,Bahía Blanca,57,1176,1356,2532,edad 50
06056,Bahía Blanca,58,1148,1403,2551,edad 50
06056,Bahía Blanca,59,1089,1277,2366,edad 50
06056,Bahía Blanca,60,1165,1388,2553,edad 60
06056,Bahía Blanca,61,1062,1254,2316,edad 60
06056,Bahía Blanca,62,1052,1229,2281,edad 60
06056,Bahía Blanca,63,1016,1254,2270,edad 60
06056,Bahía Blanca,64,911,1113,2024,edad 60
06056,Bahía Blanca,65,1020,1319,2339,edad 60
06056,Bahía Blanca,66,920,1180,2100,edad 60
06056,Bahía Blanca,67,866,1108,1974,edad 60
06056,Bahía Blanca,68,899,1143,2042,edad 60
06056,Bahía Blanca,69,847,1056,1903,edad 60
06056,Bahía Blanca,70,858,1203,2061,edad 70
06056,Bahía Blanca,71,825,1101,1926,edad 70
06056,Bahía Blanca,72,747,1170,1917,edad 70
06056,Bahía Blanca,73,756,1060,1816,edad 70
06056,Bahía Blanca,74,686,1050,1736,edad 70
06056,Bahía Blanca,75,654,1029,1683,edad 70
06056,Bahía Blanca,76,640,1003,1643,edad 70
06056,Bahía Blanca,77,589,925,1514,edad 70
06056,Bahía Blanca,78,536,941,1477,edad 70
06056,Bahía Blanca,79,463,814,1277,edad 70
06056,Bahía Blanca,80,421,796,1217,edad 80
06056,Bahía Blanca,81,390,636,1026,edad 80
06056,Bahía Blanca,82,334,624,958,edad 80
06056,Bahía Blanca,83,278,543,821,edad 80
06056,Bahía Blanca,84,236,503,739,edad 80
06056,Bahía Blanca,85,185,499,684,edad 80
06056,Bahía Blanca,86,171,454,625,edad 80
06056,Bahía Blanca,87,139,381,520,edad 80
06056,Bahía Blanca,88,103,295,398,edad 80
06056,Bahía Blanca,89,100,237,337,edad 80
06056,Bahía Blanca,90,68,203,271,edad 90
06056,Bahía Blanca,91,43,163,206,edad 90
06056,Bahía Blanca,92,38,106,144,edad 90
06056,Bahía Blanca,93,18,78,96,edad 90
06056,Bahía Blanca,94,26,66,92,edad 90
06056,Bahía Blanca,95,12,54,66,edad 90
06056,Bahía Blanca,96,8,35,43,edad 90
06056,Bahía Blanca,97,9,21,30,edad 90
06056,Bahía Blanca,98,2,14,16,edad 90
06056,Bahía Blanca,99,3,11,14,edad 90
06063,Balcarce,0,311,314,625,edad 0
06063,Balcarce,1,315,295,610,edad 0
06063,Balcarce,2,348,337,685,edad 0
06063,Balcarce,3,333,357,690,edad 0
06063,Balcarce,4,360,323,683,edad 0
06063,Balcarce,5,337,335,672,edad 0
06063,Balcarce,6,342,334,676,edad 0
06063,Balcarce,7,324,337,661,edad 0
06063,Balcarce,8,344,318,662,edad 0
06063,Balcarce,9,378,366,744,edad 0
06063,Balcarce,10,382,372,754,edad 10
06063,Balcarce,11,377,366,743,edad 10
06063,Balcarce,12,383,345,728,edad 10
06063,Balcarce,13,381,382,763,edad 10
06063,Balcarce,14,392,373,765,edad 10
06063,Balcarce,15,391,394,785,edad 10
06063,Balcarce,16,329,377,706,edad 10
06063,Balcarce,17,334,394,728,edad 10
06063,Balcarce,18,356,347,703,edad 10
06063,Balcarce,19,344,335,679,edad 10
06063,Balcarce,20,344,343,687,edad 20
06063,Balcarce,21,311,360,671,edad 20
06063,Balcarce,22,340,320,660,edad 20
06063,Balcarce,23,324,327,651,edad 20
06063,Balcarce,24,303,285,588,edad 20
06063,Balcarce,25,309,325,634,edad 20
06063,Balcarce,26,266,283,549,edad 20
06063,Balcarce,27,291,316,607,edad 20
06063,Balcarce,28,290,279,569,edad 20
06063,Balcarce,29,287,258,545,edad 20
06063,Balcarce,30,279,277,556,edad 30
06063,Balcarce,31,260,242,502,edad 30
06063,Balcarce,32,249,261,510,edad 30
06063,Balcarce,33,234,257,491,edad 30
06063,Balcarce,34,235,241,476,edad 30
06063,Balcarce,35,253,277,530,edad 30
06063,Balcarce,36,243,285,528,edad 30
06063,Balcarce,37,250,257,507,edad 30
06063,Balcarce,38,273,284,557,edad 30
06063,Balcarce,39,240,252,492,edad 30
06063,Balcarce,40,266,263,529,edad 40
06063,Balcarce,41,283,267,550,edad 40
06063,Balcarce,42,258,230,488,edad 40
06063,Balcarce,43,237,252,489,edad 40
06063,Balcarce,44,248,272,520,edad 40
06063,Balcarce,45,261,260,521,edad 40
06063,Balcarce,46,208,252,460,edad 40
06063,Balcarce,47,268,241,509,edad 40
06063,Balcarce,48,239,246,485,edad 40
06063,Balcarce,49,229,215,444,edad 40
06063,Balcarce,50,239,262,501,edad 50
06063,Balcarce,51,244,227,471,edad 50
06063,Balcarce,52,237,257,494,edad 50
06063,Balcarce,53,220,234,454,edad 50
06063,Balcarce,54,230,222,452,edad 50
06063,Balcarce,55,191,215,406,edad 50
06063,Balcarce,56,204,228,432,edad 50
06063,Balcarce,57,197,228,425,edad 50
06063,Balcarce,58,195,220,415,edad 50
06063,Balcarce,59,177,203,380,edad 50
06063,Balcarce,60,191,199,390,edad 60
06063,Balcarce,61,189,156,345,edad 60
06063,Balcarce,62,176,195,371,edad 60
06063,Balcarce,63,180,179,359,edad 60
06063,Balcarce,64,175,185,360,edad 60
06063,Balcarce,65,209,165,374,edad 60
06063,Balcarce,66,158,166,324,edad 60
06063,Balcarce,67,158,181,339,edad 60
06063,Balcarce,68,155,168,323,edad 60
06063,Balcarce,69,160,141,301,edad 60
06063,Balcarce,70,165,183,348,edad 70
06063,Balcarce,71,162,168,330,edad 70
06063,Balcarce,72,123,168,291,edad 70
06063,Balcarce,73,146,134,280,edad 70
06063,Balcarce,74,138,170,308,edad 70
06063,Balcarce,75,101,170,271,edad 70
06063,Balcarce,76,106,129,235,edad 70
06063,Balcarce,77,101,117,218,edad 70
06063,Balcarce,78,90,108,198,edad 70
06063,Balcarce,79,73,104,177,edad 70
06063,Balcarce,80,62,96,158,edad 80
06063,Balcarce,81,60,94,154,edad 80
06063,Balcarce,82,41,91,132,edad 80
06063,Balcarce,83,47,73,120,edad 80
06063,Balcarce,84,24,56,80,edad 80
06063,Balcarce,85,32,66,98,edad 80
06063,Balcarce,86,22,66,88,edad 80
06063,Balcarce,87,22,39,61,edad 80
06063,Balcarce,88,21,32,53,edad 80
06063,Balcarce,89,10,23,33,edad 80
06063,Balcarce,90,9,26,35,edad 90
06063,Balcarce,91,3,17,20,edad 90
06063,Balcarce,92,5,15,20,edad 90
06063,Balcarce,93,7,13,20,edad 90
06063,Balcarce,94,2,3,5,edad 90
06063,Balcarce,95,0,4,4,edad 90
06063,Balcarce,96,3,5,8,edad 90
06063,Balcarce,97,0,4,4,edad 90
06063,Balcarce,98,0,1,1,edad 90
06063,Balcarce,99,2,1,3,edad 90
06070,Baradero,0,286,256,542,edad 0
06070,Baradero,1,241,203,444,edad 0
06070,Baradero,2,264,257,521,edad 0
06070,Baradero,3,285,264,549,edad 0
06070,Baradero,4,268,226,494,edad 0
06070,Baradero,5,276,217,493,edad 0
06070,Baradero,6,250,252,502,edad 0
06070,Baradero,7,263,247,510,edad 0
06070,Baradero,8,255,238,493,edad 0
06070,Baradero,9,242,249,491,edad 0
06070,Baradero,10,302,259,561,edad 10
06070,Baradero,11,313,266,579,edad 10
06070,Baradero,12,240,243,483,edad 10
06070,Baradero,13,271,263,534,edad 10
06070,Baradero,14,266,231,497,edad 10
06070,Baradero,15,250,236,486,edad 10
06070,Baradero,16,235,213,448,edad 10
06070,Baradero,17,234,251,485,edad 10
06070,Baradero,18,216,232,448,edad 10
06070,Baradero,19,276,260,536,edad 10
06070,Baradero,20,257,236,493,edad 20
06070,Baradero,21,257,273,530,edad 20
06070,Baradero,22,232,255,487,edad 20
06070,Baradero,23,232,244,476,edad 20
06070,Baradero,24,238,238,476,edad 20
06070,Baradero,25,213,216,429,edad 20
06070,Baradero,26,219,193,412,edad 20
06070,Baradero,27,191,222,413,edad 20
06070,Baradero,28,187,211,398,edad 20
06070,Baradero,29,185,189,374,edad 20
06070,Baradero,30,218,205,423,edad 30
06070,Baradero,31,176,194,370,edad 30
06070,Baradero,32,205,180,385,edad 30
06070,Baradero,33,167,190,357,edad 30
06070,Baradero,34,182,204,386,edad 30
06070,Baradero,35,165,148,313,edad 30
06070,Baradero,36,173,193,366,edad 30
06070,Baradero,37,175,203,378,edad 30
06070,Baradero,38,179,170,349,edad 30
06070,Baradero,39,164,180,344,edad 30
06070,Baradero,40,194,173,367,edad 40
06070,Baradero,41,162,175,337,edad 40
06070,Baradero,42,187,176,363,edad 40
06070,Baradero,43,159,160,319,edad 40
06070,Baradero,44,172,172,344,edad 40
06070,Baradero,45,201,174,375,edad 40
06070,Baradero,46,152,199,351,edad 40
06070,Baradero,47,172,162,334,edad 40
06070,Baradero,48,151,154,305,edad 40
06070,Baradero,49,169,166,335,edad 40
06070,Baradero,50,160,193,353,edad 50
06070,Baradero,51,161,163,324,edad 50
06070,Baradero,52,137,155,292,edad 50
06070,Baradero,53,156,148,304,edad 50
06070,Baradero,54,176,135,311,edad 50
06070,Baradero,55,136,131,267,edad 50
06070,Baradero,56,141,168,309,edad 50
06070,Baradero,57,139,122,261,edad 50
06070,Baradero,58,140,131,271,edad 50
06070,Baradero,59,107,101,208,edad 50
06070,Baradero,60,126,136,262,edad 60
06070,Baradero,61,127,116,243,edad 60
06070,Baradero,62,115,128,243,edad 60
06070,Baradero,63,110,123,233,edad 60
06070,Baradero,64,109,137,246,edad 60
06070,Baradero,65,106,120,226,edad 60
06070,Baradero,66,92,118,210,edad 60
06070,Baradero,67,104,93,197,edad 60
06070,Baradero,68,89,99,188,edad 60
06070,Baradero,69,94,107,201,edad 60
06070,Baradero,70,103,142,245,edad 70
06070,Baradero,71,91,118,209,edad 70
06070,Baradero,72,101,135,236,edad 70
06070,Baradero,73,90,118,208,edad 70
06070,Baradero,74,76,95,171,edad 70
06070,Baradero,75,69,109,178,edad 70
06070,Baradero,76,66,103,169,edad 70
06070,Baradero,77,63,87,150,edad 70
06070,Baradero,78,58,89,147,edad 70
06070,Baradero,79,40,76,116,edad 70
06070,Baradero,80,41,91,132,edad 80
06070,Baradero,81,57,60,117,edad 80
06070,Baradero,82,24,64,88,edad 80
06070,Baradero,83,37,62,99,edad 80
06070,Baradero,84,17,43,60,edad 80
06070,Baradero,85,22,51,73,edad 80
06070,Baradero,86,26,52,78,edad 80
06070,Baradero,87,15,38,53,edad 80
06070,Baradero,88,17,33,50,edad 80
06070,Baradero,89,13,35,48,edad 80
06070,Baradero,90,7,17,24,edad 90
06070,Baradero,91,6,11,17,edad 90
06070,Baradero,92,3,16,19,edad 90
06070,Baradero,93,3,10,13,edad 90
06070,Baradero,94,3,5,8,edad 90
06070,Baradero,95,4,5,9,edad 90
06070,Baradero,96,1,2,3,edad 90
06070,Baradero,97,1,2,3,edad 90
06070,Baradero,98,1,1,2,edad 90
06077,Bartolomé Mitre,0,253,231,484,edad 0
06077,Bartolomé Mitre,1,230,243,473,edad 0
06077,Bartolomé Mitre,2,253,226,479,edad 0
06077,Bartolomé Mitre,3,226,221,447,edad 0
06077,Bartolomé Mitre,4,246,250,496,edad 0
06077,Bartolomé Mitre,5,238,232,470,edad 0
06077,Bartolomé Mitre,6,235,256,491,edad 0
06077,Bartolomé Mitre,7,227,256,483,edad 0
06077,Bartolomé Mitre,8,239,226,465,edad 0
06077,Bartolomé Mitre,9,237,242,479,edad 0
06077,Bartolomé Mitre,10,234,232,466,edad 10
06077,Bartolomé Mitre,11,262,264,526,edad 10
06077,Bartolomé Mitre,12,228,254,482,edad 10
06077,Bartolomé Mitre,13,219,214,433,edad 10
06077,Bartolomé Mitre,14,218,243,461,edad 10
06077,Bartolomé Mitre,15,238,236,474,edad 10
06077,Bartolomé Mitre,16,240,241,481,edad 10
06077,Bartolomé Mitre,17,197,205,402,edad 10
06077,Bartolomé Mitre,18,208,224,432,edad 10
06077,Bartolomé Mitre,19,212,224,436,edad 10
06077,Bartolomé Mitre,20,239,198,437,edad 20
06077,Bartolomé Mitre,21,212,206,418,edad 20
06077,Bartolomé Mitre,22,186,209,395,edad 20
06077,Bartolomé Mitre,23,184,227,411,edad 20
06077,Bartolomé Mitre,24,194,227,421,edad 20
06077,Bartolomé Mitre,25,198,191,389,edad 20
06077,Bartolomé Mitre,26,178,196,374,edad 20
06077,Bartolomé Mitre,27,187,198,385,edad 20
06077,Bartolomé Mitre,28,193,174,367,edad 20
06077,Bartolomé Mitre,29,180,169,349,edad 20
06077,Bartolomé Mitre,30,173,176,349,edad 30
06077,Bartolomé Mitre,31,182,172,354,edad 30
06077,Bartolomé Mitre,32,177,174,351,edad 30
06077,Bartolomé Mitre,33,151,172,323,edad 30
06077,Bartolomé Mitre,34,149,182,331,edad 30
06077,Bartolomé Mitre,35,147,172,319,edad 30
06077,Bartolomé Mitre,36,166,195,361,edad 30
06077,Bartolomé Mitre,37,156,164,320,edad 30
06077,Bartolomé Mitre,38,165,168,333,edad 30
06077,Bartolomé Mitre,39,162,161,323,edad 30
06077,Bartolomé Mitre,40,167,172,339,edad 40
06077,Bartolomé Mitre,41,142,172,314,edad 40
06077,Bartolomé Mitre,42,173,170,343,edad 40
06077,Bartolomé Mitre,43,153,168,321,edad 40
06077,Bartolomé Mitre,44,130,146,276,edad 40
06077,Bartolomé Mitre,45,165,152,317,edad 40
06077,Bartolomé Mitre,46,148,149,297,edad 40
06077,Bartolomé Mitre,47,176,151,327,edad 40
06077,Bartolomé Mitre,48,151,152,303,edad 40
06077,Bartolomé Mitre,49,138,142,280,edad 40
06077,Bartolomé Mitre,50,149,170,319,edad 50
06077,Bartolomé Mitre,51,141,155,296,edad 50
06077,Bartolomé Mitre,52,144,154,298,edad 50
06077,Bartolomé Mitre,53,145,146,291,edad 50
06077,Bartolomé Mitre,54,149,150,299,edad 50
06077,Bartolomé Mitre,55,126,139,265,edad 50
06077,Bartolomé Mitre,56,158,150,308,edad 50
06077,Bartolomé Mitre,57,127,122,249,edad 50
06077,Bartolomé Mitre,58,114,114,228,edad 50
06077,Bartolomé Mitre,59,100,121,221,edad 50
06077,Bartolomé Mitre,60,118,126,244,edad 60
06077,Bartolomé Mitre,61,89,120,209,edad 60
06077,Bartolomé Mitre,62,120,109,229,edad 60
06077,Bartolomé Mitre,63,100,124,224,edad 60
06077,Bartolomé Mitre,64,96,124,220,edad 60
06077,Bartolomé Mitre,65,102,116,218,edad 60
06077,Bartolomé Mitre,66,105,97,202,edad 60
06077,Bartolomé Mitre,67,93,103,196,edad 60
06077,Bartolomé Mitre,68,99,104,203,edad 60
06077,Bartolomé Mitre,69,64,111,175,edad 60
06077,Bartolomé Mitre,70,109,111,220,edad 70
06077,Bartolomé Mitre,71,82,119,201,edad 70
06077,Bartolomé Mitre,72,98,111,209,edad 70
06077,Bartolomé Mitre,73,59,104,163,edad 70
06077,Bartolomé Mitre,74,75,84,159,edad 70
06077,Bartolomé Mitre,75,77,107,184,edad 70
06077,Bartolomé Mitre,76,62,101,163,edad 70
06077,Bartolomé Mitre,77,49,97,146,edad 70
06077,Bartolomé Mitre,78,63,99,162,edad 70
06077,Bartolomé Mitre,79,61,89,150,edad 70
06077,Bartolomé Mitre,80,52,69,121,edad 80
06077,Bartolomé Mitre,81,41,57,98,edad 80
06077,Bartolomé Mitre,82,33,56,89,edad 80
06077,Bartolomé Mitre,83,28,66,94,edad 80
06077,Bartolomé Mitre,84,33,49,82,edad 80
06077,Bartolomé Mitre,85,38,41,79,edad 80
06077,Bartolomé Mitre,86,15,36,51,edad 80
06077,Bartolomé Mitre,87,15,28,43,edad 80
06077,Bartolomé Mitre,88,12,22,34,edad 80
06077,Bartolomé Mitre,89,16,25,41,edad 80
06077,Bartolomé Mitre,90,12,16,28,edad 90
06077,Bartolomé Mitre,91,5,19,24,edad 90
06077,Bartolomé Mitre,92,4,13,17,edad 90
06077,Bartolomé Mitre,93,2,8,10,edad 90
06077,Bartolomé Mitre,94,4,7,11,edad 90
06077,Bartolomé Mitre,95,1,5,6,edad 90
06077,Bartolomé Mitre,96,2,2,4,edad 90
06077,Bartolomé Mitre,97,2,2,4,edad 90
06077,Bartolomé Mitre,98,1,0,1,edad 90
06077,Bartolomé Mitre,99,0,2,2,edad 90
06084,Benito Juárez,0,178,161,339,edad 0
06084,Benito Juárez,1,168,175,343,edad 0
06084,Benito Juárez,2,176,151,327,edad 0
06084,Benito Juárez,3,160,153,313,edad 0
06084,Benito Juárez,4,164,143,307,edad 0
06084,Benito Juárez,5,159,150,309,edad 0
06084,Benito Juárez,6,173,153,326,edad 0
06084,Benito Juárez,7,155,175,330,edad 0
06084,Benito Juárez,8,175,153,328,edad 0
06084,Benito Juárez,9,193,167,360,edad 0
06084,Benito Juárez,10,185,185,370,edad 10
06084,Benito Juárez,11,201,172,373,edad 10
06084,Benito Juárez,12,184,190,374,edad 10
06084,Benito Juárez,13,169,162,331,edad 10
06084,Benito Juárez,14,185,160,345,edad 10
06084,Benito Juárez,15,174,169,343,edad 10
06084,Benito Juárez,16,157,172,329,edad 10
06084,Benito Juárez,17,158,154,312,edad 10
06084,Benito Juárez,18,156,132,288,edad 10
06084,Benito Juárez,19,123,123,246,edad 10
06084,Benito Juárez,20,134,120,254,edad 20
06084,Benito Juárez,21,146,144,290,edad 20
06084,Benito Juárez,22,149,137,286,edad 20
06084,Benito Juárez,23,133,117,250,edad 20
06084,Benito Juárez,24,139,100,239,edad 20
06084,Benito Juárez,25,100,116,216,edad 20
06084,Benito Juárez,26,109,126,235,edad 20
06084,Benito Juárez,27,92,121,213,edad 20
06084,Benito Juárez,28,115,141,256,edad 20
06084,Benito Juárez,29,123,139,262,edad 20
06084,Benito Juárez,30,126,117,243,edad 30
06084,Benito Juárez,31,118,117,235,edad 30
06084,Benito Juárez,32,121,115,236,edad 30
06084,Benito Juárez,33,130,133,263,edad 30
06084,Benito Juárez,34,117,125,242,edad 30
06084,Benito Juárez,35,141,128,269,edad 30
06084,Benito Juárez,36,119,135,254,edad 30
06084,Benito Juárez,37,118,132,250,edad 30
06084,Benito Juárez,38,122,115,237,edad 30
06084,Benito Juárez,39,121,127,248,edad 30
06084,Benito Juárez,40,111,110,221,edad 40
06084,Benito Juárez,41,126,132,258,edad 40
06084,Benito Juárez,42,129,110,239,edad 40
06084,Benito Juárez,43,116,123,239,edad 40
06084,Benito Juárez,44,96,109,205,edad 40
06084,Benito Juárez,45,114,137,251,edad 40
06084,Benito Juárez,46,108,108,216,edad 40
06084,Benito Juárez,47,97,121,218,edad 40
06084,Benito Juárez,48,111,125,236,edad 40
06084,Benito Juárez,49,92,113,205,edad 40
06084,Benito Juárez,50,110,138,248,edad 50
06084,Benito Juárez,51,112,94,206,edad 50
06084,Benito Juárez,52,122,108,230,edad 50
06084,Benito Juárez,53,111,106,217,edad 50
06084,Benito Juárez,54,119,125,244,edad 50
06084,Benito Juárez,55,119,105,224,edad 50
06084,Benito Juárez,56,98,112,210,edad 50
06084,Benito Juárez,57,102,94,196,edad 50
06084,Benito Juárez,58,95,111,206,edad 50
06084,Benito Juárez,59,93,79,172,edad 50
06084,Benito Juárez,60,109,94,203,edad 60
06084,Benito Juárez,61,103,118,221,edad 60
06084,Benito Juárez,62,89,65,154,edad 60
06084,Benito Juárez,63,84,85,169,edad 60
06084,Benito Juárez,64,91,65,156,edad 60
06084,Benito Juárez,65,87,77,164,edad 60
06084,Benito Juárez,66,77,87,164,edad 60
06084,Benito Juárez,67,80,77,157,edad 60
06084,Benito Juárez,68,64,85,149,edad 60
06084,Benito Juárez,69,60,75,135,edad 60
06084,Benito Juárez,70,81,84,165,edad 70
06084,Benito Juárez,71,70,68,138,edad 70
06084,Benito Juárez,72,82,84,166,edad 70
06084,Benito Juárez,73,50,84,134,edad 70
06084,Benito Juárez,74,48,74,122,edad 70
06084,Benito Juárez,75,47,70,117,edad 70
06084,Benito Juárez,76,39,66,105,edad 70
06084,Benito Juárez,77,37,53,90,edad 70
06084,Benito Juárez,78,35,56,91,edad 70
06084,Benito Juárez,79,26,48,74,edad 70
06084,Benito Juárez,80,27,57,84,edad 80
06084,Benito Juárez,81,36,54,90,edad 80
06084,Benito Juárez,82,17,38,55,edad 80
06084,Benito Juárez,83,8,46,54,edad 80
06084,Benito Juárez,84,16,34,50,edad 80
06084,Benito Juárez,85,8,28,36,edad 80
06084,Benito Juárez,86,15,26,41,edad 80
06084,Benito Juárez,87,12,16,28,edad 80
06084,Benito Juárez,88,6,26,32,edad 80
06084,Benito Juárez,89,6,16,22,edad 80
06084,Benito Juárez,90,3,11,14,edad 90
06084,Benito Juárez,91,4,9,13,edad 90
06084,Benito Juárez,92,2,8,10,edad 90
06084,Benito Juárez,93,0,6,6,edad 90
06084,Benito Juárez,94,0,9,9,edad 90
06084,Benito Juárez,95,1,7,8,edad 90
06084,Benito Juárez,96,0,1,1,edad 90
06084,Benito Juárez,97,0,2,2,edad 90
06084,Benito Juárez,99,0,2,2,edad 90
06098,Berisso,0,739,723,1462,edad 0
06098,Berisso,1,596,626,1222,edad 0
06098,Berisso,2,704,702,1406,edad 0
06098,Berisso,3,703,705,1408,edad 0
06098,Berisso,4,715,700,1415,edad 0
06098,Berisso,5,789,703,1492,edad 0
06098,Berisso,6,749,714,1463,edad 0
06098,Berisso,7,733,710,1443,edad 0
06098,Berisso,8,687,733,1420,edad 0
06098,Berisso,9,708,676,1384,edad 0
06098,Berisso,10,737,747,1484,edad 10
06098,Berisso,11,769,666,1435,edad 10
06098,Berisso,12,721,660,1381,edad 10
06098,Berisso,13,692,647,1339,edad 10
06098,Berisso,14,694,713,1407,edad 10
06098,Berisso,15,702,683,1385,edad 10
06098,Berisso,16,666,650,1316,edad 10
06098,Berisso,17,653,665,1318,edad 10
06098,Berisso,18,628,664,1292,edad 10
06098,Berisso,19,717,689,1406,edad 10
06098,Berisso,20,726,702,1428,edad 20
06098,Berisso,21,704,754,1458,edad 20
06098,Berisso,22,702,755,1457,edad 20
06098,Berisso,23,733,743,1476,edad 20
06098,Berisso,24,662,661,1323,edad 20
06098,Berisso,25,668,696,1364,edad 20
06098,Berisso,26,631,611,1242,edad 20
06098,Berisso,27,604,628,1232,edad 20
06098,Berisso,28,635,607,1242,edad 20
06098,Berisso,29,605,621,1226,edad 20
06098,Berisso,30,624,602,1226,edad 30
06098,Berisso,31,590,570,1160,edad 30
06098,Berisso,32,562,535,1097,edad 30
06098,Berisso,33,535,562,1097,edad 30
06098,Berisso,34,488,458,946,edad 30
06098,Berisso,35,514,539,1053,edad 30
06098,Berisso,36,491,512,1003,edad 30
06098,Berisso,37,492,494,986,edad 30
06098,Berisso,38,496,503,999,edad 30
06098,Berisso,39,498,478,976,edad 30
06098,Berisso,40,487,522,1009,edad 40
06098,Berisso,41,514,441,955,edad 40
06098,Berisso,42,481,499,980,edad 40
06098,Berisso,43,432,515,947,edad 40
06098,Berisso,44,408,430,838,edad 40
06098,Berisso,45,454,455,909,edad 40
06098,Berisso,46,438,466,904,edad 40
06098,Berisso,47,406,439,845,edad 40
06098,Berisso,48,413,415,828,edad 40
06098,Berisso,49,390,409,799,edad 40
06098,Berisso,50,440,500,940,edad 50
06098,Berisso,51,423,442,865,edad 50
06098,Berisso,52,376,453,829,edad 50
06098,Berisso,53,447,432,879,edad 50
06098,Berisso,54,390,397,787,edad 50
06098,Berisso,55,354,348,702,edad 50
06098,Berisso,56,350,427,777,edad 50
06098,Berisso,57,345,373,718,edad 50
06098,Berisso,58,315,344,659,edad 50
06098,Berisso,59,299,323,622,edad 50
06098,Berisso,60,295,368,663,edad 60
06098,Berisso,61,265,319,584,edad 60
06098,Berisso,62,280,339,619,edad 60
06098,Berisso,63,254,334,588,edad 60
06098,Berisso,64,259,309,568,edad 60
06098,Berisso,65,271,314,585,edad 60
06098,Berisso,66,222,317,539,edad 60
06098,Berisso,67,247,278,525,edad 60
06098,Berisso,68,241,284,525,edad 60
06098,Berisso,69,203,279,482,edad 60
06098,Berisso,70,222,303,525,edad 70
06098,Berisso,71,212,245,457,edad 70
06098,Berisso,72,199,290,489,edad 70
06098,Berisso,73,181,249,430,edad 70
06098,Berisso,74,195,245,440,edad 70
06098,Berisso,75,163,255,418,edad 70
06098,Berisso,76,131,267,398,edad 70
06098,Berisso,77,122,223,345,edad 70
06098,Berisso,78,120,219,339,edad 70
06098,Berisso,79,105,158,263,edad 70
06098,Berisso,80,100,184,284,edad 80
06098,Berisso,81,64,142,206,edad 80
06098,Berisso,82,83,120,203,edad 80
06098,Berisso,83,59,108,167,edad 80
06098,Berisso,84,51,100,151,edad 80
06098,Berisso,85,38,64,102,edad 80
06098,Berisso,86,36,78,114,edad 80
06098,Berisso,87,27,77,104,edad 80
06098,Berisso,88,16,59,75,edad 80
06098,Berisso,89,28,56,84,edad 80
06098,Berisso,90,9,31,40,edad 90
06098,Berisso,91,8,28,36,edad 90
06098,Berisso,92,10,18,28,edad 90
06098,Berisso,93,5,11,16,edad 90
06098,Berisso,94,0,9,9,edad 90
06098,Berisso,95,2,10,12,edad 90
06098,Berisso,96,1,5,6,edad 90
06098,Berisso,97,1,4,5,edad 90
06098,Berisso,98,1,1,2,edad 90
06098,Berisso,99,0,3,3,edad 90
06105,Bolívar,0,227,226,453,edad 0
06105,Bolívar,1,204,179,383,edad 0
06105,Bolívar,2,230,228,458,edad 0
06105,Bolívar,3,248,220,468,edad 0
06105,Bolívar,4,249,229,478,edad 0
06105,Bolívar,5,256,232,488,edad 0
06105,Bolívar,6,283,279,562,edad 0
06105,Bolívar,7,254,265,519,edad 0
06105,Bolívar,8,278,259,537,edad 0
06105,Bolívar,9,254,279,533,edad 0
06105,Bolívar,10,285,260,545,edad 10
06105,Bolívar,11,270,258,528,edad 10
06105,Bolívar,12,268,251,519,edad 10
06105,Bolívar,13,256,222,478,edad 10
06105,Bolívar,14,252,258,510,edad 10
06105,Bolívar,15,276,251,527,edad 10
06105,Bolívar,16,221,277,498,edad 10
06105,Bolívar,17,246,238,484,edad 10
06105,Bolívar,18,258,237,495,edad 10
06105,Bolívar,19,226,230,456,edad 10
06105,Bolívar,20,224,216,440,edad 20
06105,Bolívar,21,207,192,399,edad 20
06105,Bolívar,22,226,195,421,edad 20
06105,Bolívar,23,196,178,374,edad 20
06105,Bolívar,24,193,231,424,edad 20
06105,Bolívar,25,213,192,405,edad 20
06105,Bolívar,26,204,184,388,edad 20
06105,Bolívar,27,205,208,413,edad 20
06105,Bolívar,28,185,210,395,edad 20
06105,Bolívar,29,160,188,348,edad 20
06105,Bolívar,30,176,200,376,edad 30
06105,Bolívar,31,154,152,306,edad 30
06105,Bolívar,32,167,175,342,edad 30
06105,Bolívar,33,169,181,350,edad 30
06105,Bolívar,34,172,170,342,edad 30
06105,Bolívar,35,184,173,357,edad 30
06105,Bolívar,36,204,199,403,edad 30
06105,Bolívar,37,169,190,359,edad 30
06105,Bolívar,38,182,219,401,edad 30
06105,Bolívar,39,173,187,360,edad 30
06105,Bolívar,40,197,200,397,edad 40
06105,Bolívar,41,205,221,426,edad 40
06105,Bolívar,42,209,188,397,edad 40
06105,Bolívar,43,178,214,392,edad 40
06105,Bolívar,44,158,196,354,edad 40
06105,Bolívar,45,167,178,345,edad 40
06105,Bolívar,46,178,188,366,edad 40
06105,Bolívar,47,190,186,376,edad 40
06105,Bolívar,48,193,210,403,edad 40
06105,Bolívar,49,166,189,355,edad 40
06105,Bolívar,50,219,221,440,edad 50
06105,Bolívar,51,180,188,368,edad 50
06105,Bolívar,52,234,211,445,edad 50
06105,Bolívar,53,177,224,401,edad 50
06105,Bolívar,54,181,215,396,edad 50
06105,Bolívar,55,180,189,369,edad 50
06105,Bolívar,56,218,208,426,edad 50
06105,Bolívar,57,195,173,368,edad 50
06105,Bolívar,58,192,167,359,edad 50
06105,Bolívar,59,149,155,304,edad 50
06105,Bolívar,60,168,179,347,edad 60
06105,Bolívar,61,180,167,347,edad 60
06105,Bolívar,62,163,211,374,edad 60
06105,Bolívar,63,165,158,323,edad 60
06105,Bolívar,64,146,182,328,edad 60
06105,Bolívar,65,183,161,344,edad 60
06105,Bolívar,66,159,154,313,edad 60
06105,Bolívar,67,137,160,297,edad 60
06105,Bolívar,68,131,186,317,edad 60
06105,Bolívar,69,118,148,266,edad 60
06105,Bolívar,70,121,173,294,edad 70
06105,Bolívar,71,124,161,285,edad 70
06105,Bolívar,72,142,157,299,edad 70
06105,Bolívar,73,141,143,284,edad 70
06105,Bolívar,74,124,155,279,edad 70
06105,Bolívar,75,126,146,272,edad 70
06105,Bolívar,76,103,130,233,edad 70
06105,Bolívar,77,84,120,204,edad 70
06105,Bolívar,78,96,148,244,edad 70
06105,Bolívar,79,82,98,180,edad 70
06105,Bolívar,80,82,109,191,edad 80
06105,Bolívar,81,68,121,189,edad 80
06105,Bolívar,82,63,91,154,edad 80
06105,Bolívar,83,45,99,144,edad 80
06105,Bolívar,84,35,93,128,edad 80
06105,Bolívar,85,40,67,107,edad 80
06105,Bolívar,86,35,77,112,edad 80
06105,Bolívar,87,25,56,81,edad 80
06105,Bolívar,88,18,50,68,edad 80
06105,Bolívar,89,21,33,54,edad 80
06105,Bolívar,90,14,39,53,edad 90
06105,Bolívar,91,5,22,27,edad 90
06105,Bolívar,92,6,17,23,edad 90
06105,Bolívar,93,5,17,22,edad 90
06105,Bolívar,94,2,12,14,edad 90
06105,Bolívar,95,3,10,13,edad 90
06105,Bolívar,96,2,5,7,edad 90
06105,Bolívar,97,1,6,7,edad 90
06105,Bolívar,98,0,3,3,edad 90
06105,Bolívar,99,0,2,2,edad 90
06112,Bragado,0,315,276,591,edad 0
06112,Bragado,1,309,246,555,edad 0
06112,Bragado,2,304,298,602,edad 0
06112,Bragado,3,344,305,649,edad 0
06112,Bragado,4,331,316,647,edad 0
06112,Bragado,5,347,308,655,edad 0
06112,Bragado,6,334,303,637,edad 0
06112,Bragado,7,305,327,632,edad 0
06112,Bragado,8,383,295,678,edad 0
06112,Bragado,9,371,319,690,edad 0
06112,Bragado,10,376,377,753,edad 10
06112,Bragado,11,353,363,716,edad 10
06112,Bragado,12,371,313,684,edad 10
06112,Bragado,13,336,308,644,edad 10
06112,Bragado,14,351,333,684,edad 10
06112,Bragado,15,360,314,674,edad 10
06112,Bragado,16,321,305,626,edad 10
06112,Bragado,17,302,350,652,edad 10
06112,Bragado,18,292,276,568,edad 10
06112,Bragado,19,284,266,550,edad 10
06112,Bragado,20,304,285,589,edad 20
06112,Bragado,21,321,282,603,edad 20
06112,Bragado,22,313,268,581,edad 20
06112,Bragado,23,283,268,551,edad 20
06112,Bragado,24,269,243,512,edad 20
06112,Bragado,25,246,256,502,edad 20
06112,Bragado,26,220,247,467,edad 20
06112,Bragado,27,221,254,475,edad 20
06112,Bragado,28,222,242,464,edad 20
06112,Bragado,29,222,275,497,edad 20
06112,Bragado,30,281,228,509,edad 30
06112,Bragado,31,214,247,461,edad 30
06112,Bragado,32,186,227,413,edad 30
06112,Bragado,33,200,220,420,edad 30
06112,Bragado,34,159,239,398,edad 30
06112,Bragado,35,235,253,488,edad 30
06112,Bragado,36,236,283,519,edad 30
06112,Bragado,37,254,218,472,edad 30
06112,Bragado,38,250,262,512,edad 30
06112,Bragado,39,234,273,507,edad 30
06112,Bragado,40,268,271,539,edad 40
06112,Bragado,41,195,259,454,edad 40
06112,Bragado,42,235,277,512,edad 40
06112,Bragado,43,239,264,503,edad 40
06112,Bragado,44,229,264,493,edad 40
06112,Bragado,45,251,248,499,edad 40
06112,Bragado,46,278,253,531,edad 40
06112,Bragado,47,216,244,460,edad 40
06112,Bragado,48,242,235,477,edad 40
06112,Bragado,49,217,229,446,edad 40
06112,Bragado,50,241,252,493,edad 50
06112,Bragado,51,266,237,503,edad 50
06112,Bragado,52,225,242,467,edad 50
06112,Bragado,53,253,247,500,edad 50
06112,Bragado,54,208,241,449,edad 50
06112,Bragado,55,231,223,454,edad 50
06112,Bragado,56,226,216,442,edad 50
06112,Bragado,57,212,199,411,edad 50
06112,Bragado,58,197,211,408,edad 50
06112,Bragado,59,160,173,333,edad 50
06112,Bragado,60,180,205,385,edad 60
06112,Bragado,61,148,186,334,edad 60
06112,Bragado,62,186,208,394,edad 60
06112,Bragado,63,184,192,376,edad 60
06112,Bragado,64,175,211,386,edad 60
06112,Bragado,65,172,206,378,edad 60
06112,Bragado,66,159,191,350,edad 60
06112,Bragado,67,162,163,325,edad 60
06112,Bragado,68,148,211,359,edad 60
06112,Bragado,69,171,198,369,edad 60
06112,Bragado,70,179,174,353,edad 70
06112,Bragado,71,146,197,343,edad 70
06112,Bragado,72,175,185,360,edad 70
06112,Bragado,73,140,197,337,edad 70
06112,Bragado,74,129,173,302,edad 70
06112,Bragado,75,126,169,295,edad 70
06112,Bragado,76,122,167,289,edad 70
06112,Bragado,77,96,150,246,edad 70
06112,Bragado,78,101,156,257,edad 70
06112,Bragado,79,73,116,189,edad 70
06112,Bragado,80,89,137,226,edad 80
06112,Bragado,81,50,112,162,edad 80
06112,Bragado,82,61,113,174,edad 80
06112,Bragado,83,39,81,120,edad 80
06112,Bragado,84,31,76,107,edad 80
06112,Bragado,85,45,76,121,edad 80
06112,Bragado,86,40,72,112,edad 80
06112,Bragado,87,32,69,101,edad 80
06112,Bragado,88,23,44,67,edad 80
06112,Bragado,89,17,41,58,edad 80
06112,Bragado,90,13,24,37,edad 90
06112,Bragado,91,15,28,43,edad 90
06112,Bragado,92,14,30,44,edad 90
06112,Bragado,93,5,12,17,edad 90
06112,Bragado,94,4,9,13,edad 90
06112,Bragado,95,3,6,9,edad 90
06112,Bragado,96,0,6,6,edad 90
06112,Bragado,97,1,3,4,edad 90
06112,Bragado,98,1,4,5,edad 90
06112,Bragado,99,1,2,3,edad 90
06119,Brandsen,0,221,213,434,edad 0
06119,Brandsen,1,191,212,403,edad 0
06119,Brandsen,2,235,201,436,edad 0
06119,Brandsen,3,221,197,418,edad 0
06119,Brandsen,4,221,226,447,edad 0
06119,Brandsen,5,211,210,421,edad 0
06119,Brandsen,6,215,213,428,edad 0
06119,Brandsen,7,216,185,401,edad 0
06119,Brandsen,8,246,201,447,edad 0
06119,Brandsen,9,192,229,421,edad 0
06119,Brandsen,10,249,195,444,edad 10
06119,Brandsen,11,240,233,473,edad 10
06119,Brandsen,12,200,182,382,edad 10
06119,Brandsen,13,207,213,420,edad 10
06119,Brandsen,14,196,196,392,edad 10
06119,Brandsen,15,199,190,389,edad 10
06119,Brandsen,16,187,176,363,edad 10
06119,Brandsen,17,207,197,404,edad 10
06119,Brandsen,18,200,179,379,edad 10
06119,Brandsen,19,203,195,398,edad 10
06119,Brandsen,20,212,171,383,edad 20
06119,Brandsen,21,213,214,427,edad 20
06119,Brandsen,22,209,208,417,edad 20
06119,Brandsen,23,173,181,354,edad 20
06119,Brandsen,24,171,180,351,edad 20
06119,Brandsen,25,179,158,337,edad 20
06119,Brandsen,26,187,195,382,edad 20
06119,Brandsen,27,152,164,316,edad 20
06119,Brandsen,28,187,188,375,edad 20
06119,Brandsen,29,178,149,327,edad 20
06119,Brandsen,30,158,165,323,edad 30
06119,Brandsen,31,163,165,328,edad 30
06119,Brandsen,32,143,156,299,edad 30
06119,Brandsen,33,137,148,285,edad 30
06119,Brandsen,34,127,136,263,edad 30
06119,Brandsen,35,125,112,237,edad 30
06119,Brandsen,36,136,122,258,edad 30
06119,Brandsen,37,123,119,242,edad 30
06119,Brandsen,38,150,135,285,edad 30
06119,Brandsen,39,126,134,260,edad 30
06119,Brandsen,40,126,123,249,edad 40
06119,Brandsen,41,134,144,278,edad 40
06119,Brandsen,42,120,133,253,edad 40
06119,Brandsen,43,126,118,244,edad 40
06119,Brandsen,44,113,126,239,edad 40
06119,Brandsen,45,131,155,286,edad 40
06119,Brandsen,46,131,118,249,edad 40
06119,Brandsen,47,127,115,242,edad 40
06119,Brandsen,48,104,109,213,edad 40
06119,Brandsen,49,107,127,234,edad 40
06119,Brandsen,50,106,132,238,edad 50
06119,Brandsen,51,130,124,254,edad 50
06119,Brandsen,52,117,120,237,edad 50
06119,Brandsen,53,127,127,254,edad 50
06119,Brandsen,54,118,98,216,edad 50
06119,Brandsen,55,104,109,213,edad 50
06119,Brandsen,56,133,121,254,edad 50
06119,Brandsen,57,95,90,185,edad 50
06119,Brandsen,58,93,73,166,edad 50
06119,Brandsen,59,87,84,171,edad 50
06119,Brandsen,60,81,102,183,edad 60
06119,Brandsen,61,81,96,177,edad 60
06119,Brandsen,62,92,78,170,edad 60
06119,Brandsen,63,62,70,132,edad 60
06119,Brandsen,64,75,75,150,edad 60
06119,Brandsen,65,86,86,172,edad 60
06119,Brandsen,66,71,68,139,edad 60
06119,Brandsen,67,58,92,150,edad 60
06119,Brandsen,68,64,64,128,edad 60
06119,Brandsen,69,68,66,134,edad 60
06119,Brandsen,70,66,89,155,edad 70
06119,Brandsen,71,54,82,136,edad 70
06119,Brandsen,72,49,56,105,edad 70
06119,Brandsen,73,52,59,111,edad 70
06119,Brandsen,74,42,79,121,edad 70
06119,Brandsen,75,42,63,105,edad 70
06119,Brandsen,76,44,48,92,edad 70
06119,Brandsen,77,37,44,81,edad 70
06119,Brandsen,78,25,54,79,edad 70
06119,Brandsen,79,30,40,70,edad 70
06119,Brandsen,80,26,45,71,edad 80
06119,Brandsen,81,31,33,64,edad 80
06119,Brandsen,82,17,32,49,edad 80
06119,Brandsen,83,18,41,59,edad 80
06119,Brandsen,84,11,27,38,edad 80
06119,Brandsen,85,13,22,35,edad 80
06119,Brandsen,86,14,27,41,edad 80
06119,Brandsen,87,10,22,32,edad 80
06119,Brandsen,88,6,11,17,edad 80
06119,Brandsen,89,8,19,27,edad 80
06119,Brandsen,90,4,12,16,edad 90
06119,Brandsen,91,3,7,10,edad 90
06119,Brandsen,92,4,9,13,edad 90
06119,Brandsen,93,1,3,4,edad 90
06119,Brandsen,94,2,6,8,edad 90
06119,Brandsen,95,0,4,4,edad 90
06119,Brandsen,96,1,3,4,edad 90
06119,Brandsen,97,1,2,3,edad 90
06119,Brandsen,98,0,2,2,edad 90
06119,Brandsen,99,1,2,3,edad 90
06126,Campana,0,824,827,1651,edad 0
06126,Campana,1,800,756,1556,edad 0
06126,Campana,2,799,788,1587,edad 0
06126,Campana,3,819,857,1676,edad 0
06126,Campana,4,845,823,1668,edad 0
06126,Campana,5,839,849,1688,edad 0
06126,Campana,6,829,800,1629,edad 0
06126,Campana,7,817,811,1628,edad 0
06126,Campana,8,783,743,1526,edad 0
06126,Campana,9,791,790,1581,edad 0
06126,Campana,10,879,792,1671,edad 10
06126,Campana,11,852,778,1630,edad 10
06126,Campana,12,813,780,1593,edad 10
06126,Campana,13,787,741,1528,edad 10
06126,Campana,14,743,766,1509,edad 10
06126,Campana,15,819,734,1553,edad 10
06126,Campana,16,751,777,1528,edad 10
06126,Campana,17,713,650,1363,edad 10
06126,Campana,18,720,691,1411,edad 10
06126,Campana,19,767,727,1494,edad 10
06126,Campana,20,751,689,1440,edad 20
06126,Campana,21,763,756,1519,edad 20
06126,Campana,22,721,682,1403,edad 20
06126,Campana,23,759,670,1429,edad 20
06126,Campana,24,707,701,1408,edad 20
06126,Campana,25,632,679,1311,edad 20
06126,Campana,26,653,676,1329,edad 20
06126,Campana,27,658,604,1262,edad 20
06126,Campana,28,681,612,1293,edad 20
06126,Campana,29,601,640,1241,edad 20
06126,Campana,30,692,698,1390,edad 30
06126,Campana,31,583,595,1178,edad 30
06126,Campana,32,537,591,1128,edad 30
06126,Campana,33,520,568,1088,edad 30
06126,Campana,34,504,524,1028,edad 30
06126,Campana,35,516,548,1064,edad 30
06126,Campana,36,563,577,1140,edad 30
06126,Campana,37,535,501,1036,edad 30
06126,Campana,38,517,540,1057,edad 30
06126,Campana,39,546,534,1080,edad 30
06126,Campana,40,569,583,1152,edad 40
06126,Campana,41,527,500,1027,edad 40
06126,Campana,42,533,522,1055,edad 40
06126,Campana,43,562,531,1093,edad 40
06126,Campana,44,499,475,974,edad 40
06126,Campana,45,502,508,1010,edad 40
06126,Campana,46,470,478,948,edad 40
06126,Campana,47,462,454,916,edad 40
06126,Campana,48,455,415,870,edad 40
06126,Campana,49,450,402,852,edad 40
06126,Campana,50,438,460,898,edad 50
06126,Campana,51,418,411,829,edad 50
06126,Campana,52,427,429,856,edad 50
06126,Campana,53,396,397,793,edad 50
06126,Campana,54,364,393,757,edad 50
06126,Campana,55,358,382,740,edad 50
06126,Campana,56,425,396,821,edad 50
06126,Campana,57,354,336,690,edad 50
06126,Campana,58,298,367,665,edad 50
06126,Campana,59,280,309,589,edad 50
06126,Campana,60,312,397,709,edad 60
06126,Campana,61,250,309,559,edad 60
06126,Campana,62,294,302,596,edad 60
06126,Campana,63,242,287,529,edad 60
06126,Campana,64,243,256,499,edad 60
06126,Campana,65,243,267,510,edad 60
06126,Campana,66,243,246,489,edad 60
06126,Campana,67,224,231,455,edad 60
06126,Campana,68,199,212,411,edad 60
06126,Campana,69,186,215,401,edad 60
06126,Campana,70,233,226,459,edad 70
06126,Campana,71,202,216,418,edad 70
06126,Campana,72,155,224,379,edad 70
06126,Campana,73,134,197,331,edad 70
06126,Campana,74,166,183,349,edad 70
06126,Campana,75,137,190,327,edad 70
06126,Campana,76,138,195,333,edad 70
06126,Campana,77,117,138,255,edad 70
06126,Campana,78,95,133,228,edad 70
06126,Campana,79,91,123,214,edad 70
06126,Campana,80,82,141,223,edad 80
06126,Campana,81,64,114,178,edad 80
06126,Campana,82,55,112,167,edad 80
06126,Campana,83,55,95,150,edad 80
06126,Campana,84,39,89,128,edad 80
06126,Campana,85,34,69,103,edad 80
06126,Campana,86,27,79,106,edad 80
06126,Campana,87,23,58,81,edad 80
06126,Campana,88,17,40,57,edad 80
06126,Campana,89,17,47,64,edad 80
06126,Campana,90,10,28,38,edad 90
06126,Campana,91,12,17,29,edad 90
06126,Campana,92,4,17,21,edad 90
06126,Campana,93,7,21,28,edad 90
06126,Campana,94,2,13,15,edad 90
06126,Campana,95,1,7,8,edad 90
06126,Campana,96,2,4,6,edad 90
06126,Campana,97,2,5,7,edad 90
06126,Campana,98,1,1,2,edad 90
06126,Campana,99,0,3,3,edad 90
06134,Cañuelas,0,410,446,856,edad 0
06134,Cañuelas,1,439,424,863,edad 0
06134,Cañuelas,2,420,400,820,edad 0
06134,Cañuelas,3,452,446,898,edad 0
06134,Cañuelas,4,446,429,875,edad 0
06134,Cañuelas,5,465,434,899,edad 0
06134,Cañuelas,6,423,405,828,edad 0
06134,Cañuelas,7,463,400,863,edad 0
06134,Cañuelas,8,443,398,841,edad 0
06134,Cañuelas,9,440,394,834,edad 0
06134,Cañuelas,10,476,437,913,edad 10
06134,Cañuelas,11,415,405,820,edad 10
06134,Cañuelas,12,445,437,882,edad 10
06134,Cañuelas,13,401,379,780,edad 10
06134,Cañuelas,14,445,392,837,edad 10
06134,Cañuelas,15,378,402,780,edad 10
06134,Cañuelas,16,401,420,821,edad 10
06134,Cañuelas,17,356,403,759,edad 10
06134,Cañuelas,18,385,324,709,edad 10
06134,Cañuelas,19,392,368,760,edad 10
06134,Cañuelas,20,410,374,784,edad 20
06134,Cañuelas,21,379,360,739,edad 20
06134,Cañuelas,22,398,423,821,edad 20
06134,Cañuelas,23,377,351,728,edad 20
06134,Cañuelas,24,337,352,689,edad 20
06134,Cañuelas,25,324,356,680,edad 20
06134,Cañuelas,26,304,334,638,edad 20
06134,Cañuelas,27,327,314,641,edad 20
06134,Cañuelas,28,345,348,693,edad 20
06134,Cañuelas,29,308,286,594,edad 20
06134,Cañuelas,30,294,311,605,edad 30
06134,Cañuelas,31,289,288,577,edad 30
06134,Cañuelas,32,276,272,548,edad 30
06134,Cañuelas,33,266,272,538,edad 30
06134,Cañuelas,34,257,261,518,edad 30
06134,Cañuelas,35,250,262,512,edad 30
06134,Cañuelas,36,238,242,480,edad 30
06134,Cañuelas,37,284,268,552,edad 30
06134,Cañuelas,38,273,278,551,edad 30
06134,Cañuelas,39,220,256,476,edad 30
06134,Cañuelas,40,235,243,478,edad 40
06134,Cañuelas,41,261,251,512,edad 40
06134,Cañuelas,42,244,269,513,edad 40
06134,Cañuelas,43,233,218,451,edad 40
06134,Cañuelas,44,252,214,466,edad 40
06134,Cañuelas,45,267,233,500,edad 40
06134,Cañuelas,46,213,235,448,edad 40
06134,Cañuelas,47,241,257,498,edad 40
06134,Cañuelas,48,246,250,496,edad 40
06134,Cañuelas,49,224,226,450,edad 40
06134,Cañuelas,50,219,242,461,edad 50
06134,Cañuelas,51,233,195,428,edad 50
06134,Cañuelas,52,224,204,428,edad 50
06134,Cañuelas,53,195,187,382,edad 50
06134,Cañuelas,54,191,197,388,edad 50
06134,Cañuelas,55,191,170,361,edad 50
06134,Cañuelas,56,193,224,417,edad 50
06134,Cañuelas,57,155,183,338,edad 50
06134,Cañuelas,58,201,126,327,edad 50
06134,Cañuelas,59,177,167,344,edad 50
06134,Cañuelas,60,151,172,323,edad 60
06134,Cañuelas,61,168,135,303,edad 60
06134,Cañuelas,62,104,127,231,edad 60
06134,Cañuelas,63,153,129,282,edad 60
06134,Cañuelas,64,132,126,258,edad 60
06134,Cañuelas,65,115,124,239,edad 60
06134,Cañuelas,66,114,100,214,edad 60
06134,Cañuelas,67,126,107,233,edad 60
06134,Cañuelas,68,95,113,208,edad 60
06134,Cañuelas,69,108,114,222,edad 60
06134,Cañuelas,70,107,121,228,edad 70
06134,Cañuelas,71,95,117,212,edad 70
06134,Cañuelas,72,93,119,212,edad 70
06134,Cañuelas,73,82,101,183,edad 70
06134,Cañuelas,74,68,99,167,edad 70
06134,Cañuelas,75,67,90,157,edad 70
06134,Cañuelas,76,67,98,165,edad 70
06134,Cañuelas,77,53,86,139,edad 70
06134,Cañuelas,78,50,80,130,edad 70
06134,Cañuelas,79,51,59,110,edad 70
06134,Cañuelas,80,38,74,112,edad 80
06134,Cañuelas,81,35,50,85,edad 80
06134,Cañuelas,82,25,45,70,edad 80
06134,Cañuelas,83,12,61,73,edad 80
06134,Cañuelas,84,19,42,61,edad 80
06134,Cañuelas,85,14,30,44,edad 80
06134,Cañuelas,86,16,19,35,edad 80
06134,Cañuelas,87,11,31,42,edad 80
06134,Cañuelas,88,7,25,32,edad 80
06134,Cañuelas,89,8,16,24,edad 80
06134,Cañuelas,90,5,13,18,edad 90
06134,Cañuelas,91,6,13,19,edad 90
06134,Cañuelas,92,2,15,17,edad 90
06134,Cañuelas,93,5,9,14,edad 90
06134,Cañuelas,94,2,3,5,edad 90
06134,Cañuelas,95,3,3,6,edad 90
06134,Cañuelas,96,0,3,3,edad 90
06134,Cañuelas,97,1,5,6,edad 90
06134,Cañuelas,99,1,2,3,edad 90
06140,Capitán Sarmiento,0,118,100,218,edad 0
06140,Capitán Sarmiento,1,120,115,235,edad 0
06140,Capitán Sarmiento,2,103,106,209,edad 0
06140,Capitán Sarmiento,3,107,117,224,edad 0
06140,Capitán Sarmiento,4,107,116,223,edad 0
06140,Capitán Sarmiento,5,126,116,242,edad 0
06140,Capitán Sarmiento,6,105,104,209,edad 0
06140,Capitán Sarmiento,7,103,129,232,edad 0
06140,Capitán Sarmiento,8,116,133,249,edad 0
06140,Capitán Sarmiento,9,85,120,205,edad 0
06140,Capitán Sarmiento,10,124,122,246,edad 10
06140,Capitán Sarmiento,11,119,125,244,edad 10
06140,Capitán Sarmiento,12,131,116,247,edad 10
06140,Capitán Sarmiento,13,115,126,241,edad 10
06140,Capitán Sarmiento,14,105,109,214,edad 10
06140,Capitán Sarmiento,15,100,96,196,edad 10
06140,Capitán Sarmiento,16,108,108,216,edad 10
06140,Capitán Sarmiento,17,98,94,192,edad 10
06140,Capitán Sarmiento,18,107,89,196,edad 10
06140,Capitán Sarmiento,19,109,97,206,edad 10
06140,Capitán Sarmiento,20,121,103,224,edad 20
06140,Capitán Sarmiento,21,110,94,204,edad 20
06140,Capitán Sarmiento,22,115,105,220,edad 20
06140,Capitán Sarmiento,23,91,88,179,edad 20
06140,Capitán Sarmiento,24,99,114,213,edad 20
06140,Capitán Sarmiento,25,94,98,192,edad 20
06140,Capitán Sarmiento,26,71,75,146,edad 20
06140,Capitán Sarmiento,27,78,63,141,edad 20
06140,Capitán Sarmiento,28,76,82,158,edad 20
06140,Capitán Sarmiento,29,81,92,173,edad 20
06140,Capitán Sarmiento,30,80,83,163,edad 30
06140,Capitán Sarmiento,31,93,85,178,edad 30
06140,Capitán Sarmiento,32,87,79,166,edad 30
06140,Capitán Sarmiento,33,73,79,152,edad 30
06140,Capitán Sarmiento,34,76,86,162,edad 30
06140,Capitán Sarmiento,35,84,78,162,edad 30
06140,Capitán Sarmiento,36,86,77,163,edad 30
06140,Capitán Sarmiento,37,77,72,149,edad 30
06140,Capitán Sarmiento,38,75,88,163,edad 30
06140,Capitán Sarmiento,39,69,94,163,edad 30
06140,Capitán Sarmiento,40,77,84,161,edad 40
06140,Capitán Sarmiento,41,91,73,164,edad 40
06140,Capitán Sarmiento,42,69,75,144,edad 40
06140,Capitán Sarmiento,43,86,78,164,edad 40
06140,Capitán Sarmiento,44,75,75,150,edad 40
06140,Capitán Sarmiento,45,75,76,151,edad 40
06140,Capitán Sarmiento,46,78,68,146,edad 40
06140,Capitán Sarmiento,47,80,80,160,edad 40
06140,Capitán Sarmiento,48,75,81,156,edad 40
06140,Capitán Sarmiento,49,67,64,131,edad 40
06140,Capitán Sarmiento,50,74,54,128,edad 50
06140,Capitán Sarmiento,51,77,64,141,edad 50
06140,Capitán Sarmiento,52,49,80,129,edad 50
06140,Capitán Sarmiento,53,73,57,130,edad 50
06140,Capitán Sarmiento,54,60,65,125,edad 50
06140,Capitán Sarmiento,55,54,62,116,edad 50
06140,Capitán Sarmiento,56,74,68,142,edad 50
06140,Capitán Sarmiento,57,56,47,103,edad 50
06140,Capitán Sarmiento,58,53,62,115,edad 50
06140,Capitán Sarmiento,59,55,61,116,edad 50
06140,Capitán Sarmiento,60,66,67,133,edad 60
06140,Capitán Sarmiento,61,63,74,137,edad 60
06140,Capitán Sarmiento,62,37,57,94,edad 60
06140,Capitán Sarmiento,63,58,65,123,edad 60
06140,Capitán Sarmiento,64,54,49,103,edad 60
06140,Capitán Sarmiento,65,49,57,106,edad 60
06140,Capitán Sarmiento,66,40,46,86,edad 60
06140,Capitán Sarmiento,67,41,50,91,edad 60
06140,Capitán Sarmiento,68,40,45,85,edad 60
06140,Capitán Sarmiento,69,33,41,74,edad 60
06140,Capitán Sarmiento,70,31,41,72,edad 70
06140,Capitán Sarmiento,71,39,57,96,edad 70
06140,Capitán Sarmiento,72,45,47,92,edad 70
06140,Capitán Sarmiento,73,32,51,83,edad 70
06140,Capitán Sarmiento,74,32,43,75,edad 70
06140,Capitán Sarmiento,75,41,40,81,edad 70
06140,Capitán Sarmiento,76,28,33,61,edad 70
06140,Capitán Sarmiento,77,26,31,57,edad 70
06140,Capitán Sarmiento,78,28,42,70,edad 70
06140,Capitán Sarmiento,79,21,32,53,edad 70
06140,Capitán Sarmiento,80,27,31,58,edad 80
06140,Capitán Sarmiento,81,21,26,47,edad 80
06140,Capitán Sarmiento,82,16,33,49,edad 80
06140,Capitán Sarmiento,83,12,30,42,edad 80
06140,Capitán Sarmiento,84,16,18,34,edad 80
06140,Capitán Sarmiento,85,8,29,37,edad 80
06140,Capitán Sarmiento,86,5,19,24,edad 80
06140,Capitán Sarmiento,87,6,23,29,edad 80
06140,Capitán Sarmiento,88,4,12,16,edad 80
06140,Capitán Sarmiento,89,4,18,22,edad 80
06140,Capitán Sarmiento,90,3,8,11,edad 90
06140,Capitán Sarmiento,91,1,4,5,edad 90
06140,Capitán Sarmiento,92,2,9,11,edad 90
06140,Capitán Sarmiento,93,2,1,3,edad 90
06140,Capitán Sarmiento,94,1,1,2,edad 90
06140,Capitán Sarmiento,95,0,2,2,edad 90
06140,Capitán Sarmiento,98,1,0,1,edad 90
06140,Capitán Sarmiento,99,0,1,1,edad 90
06147,Carlos Casares,0,177,191,368,edad 0
06147,Carlos Casares,1,174,151,325,edad 0
06147,Carlos Casares,2,172,186,358,edad 0
06147,Carlos Casares,3,184,170,354,edad 0
06147,Carlos Casares,4,178,181,359,edad 0
06147,Carlos Casares,5,190,178,368,edad 0
06147,Carlos Casares,6,198,182,380,edad 0
06147,Carlos Casares,7,188,165,353,edad 0
06147,Carlos Casares,8,177,179,356,edad 0
06147,Carlos Casares,9,179,216,395,edad 0
06147,Carlos Casares,10,196,196,392,edad 10
06147,Carlos Casares,11,166,170,336,edad 10
06147,Carlos Casares,12,178,173,351,edad 10
06147,Carlos Casares,13,167,166,333,edad 10
06147,Carlos Casares,14,182,166,348,edad 10
06147,Carlos Casares,15,175,183,358,edad 10
06147,Carlos Casares,16,193,156,349,edad 10
06147,Carlos Casares,17,160,170,330,edad 10
06147,Carlos Casares,18,177,115,292,edad 10
06147,Carlos Casares,19,130,121,251,edad 10
06147,Carlos Casares,20,131,145,276,edad 20
06147,Carlos Casares,21,147,121,268,edad 20
06147,Carlos Casares,22,166,132,298,edad 20
06147,Carlos Casares,23,111,144,255,edad 20
06147,Carlos Casares,24,135,118,253,edad 20
06147,Carlos Casares,25,127,136,263,edad 20
06147,Carlos Casares,26,120,136,256,edad 20
06147,Carlos Casares,27,117,137,254,edad 20
06147,Carlos Casares,28,137,143,280,edad 20
06147,Carlos Casares,29,142,153,295,edad 20
06147,Carlos Casares,30,133,148,281,edad 30
06147,Carlos Casares,31,153,134,287,edad 30
06147,Carlos Casares,32,126,156,282,edad 30
06147,Carlos Casares,33,120,120,240,edad 30
06147,Carlos Casares,34,120,133,253,edad 30
06147,Carlos Casares,35,121,131,252,edad 30
06147,Carlos Casares,36,147,155,302,edad 30
06147,Carlos Casares,37,152,157,309,edad 30
06147,Carlos Casares,38,169,147,316,edad 30
06147,Carlos Casares,39,124,151,275,edad 30
06147,Carlos Casares,40,140,120,260,edad 40
06147,Carlos Casares,41,146,123,269,edad 40
06147,Carlos Casares,42,129,126,255,edad 40
06147,Carlos Casares,43,150,116,266,edad 40
06147,Carlos Casares,44,118,111,229,edad 40
06147,Carlos Casares,45,122,102,224,edad 40
06147,Carlos Casares,46,117,122,239,edad 40
06147,Carlos Casares,47,114,139,253,edad 40
06147,Carlos Casares,48,113,110,223,edad 40
06147,Carlos Casares,49,112,101,213,edad 40
06147,Carlos Casares,50,118,121,239,edad 50
06147,Carlos Casares,51,127,118,245,edad 50
06147,Carlos Casares,52,112,126,238,edad 50
06147,Carlos Casares,53,115,126,241,edad 50
06147,Carlos Casares,54,87,113,200,edad 50
06147,Carlos Casares,55,116,107,223,edad 50
06147,Carlos Casares,56,142,108,250,edad 50
06147,Carlos Casares,57,106,86,192,edad 50
06147,Carlos Casares,58,99,115,214,edad 50
06147,Carlos Casares,59,105,85,190,edad 50
06147,Carlos Casares,60,96,100,196,edad 60
06147,Carlos Casares,61,81,102,183,edad 60
06147,Carlos Casares,62,81,87,168,edad 60
06147,Carlos Casares,63,88,98,186,edad 60
06147,Carlos Casares,64,94,112,206,edad 60
06147,Carlos Casares,65,97,100,197,edad 60
06147,Carlos Casares,66,82,89,171,edad 60
06147,Carlos Casares,67,88,67,155,edad 60
06147,Carlos Casares,68,88,72,160,edad 60
06147,Carlos Casares,69,69,102,171,edad 60
06147,Carlos Casares,70,78,106,184,edad 70
06147,Carlos Casares,71,76,90,166,edad 70
06147,Carlos Casares,72,85,89,174,edad 70
06147,Carlos Casares,73,84,108,192,edad 70
06147,Carlos Casares,74,59,84,143,edad 70
06147,Carlos Casares,75,58,78,136,edad 70
06147,Carlos Casares,76,59,79,138,edad 70
06147,Carlos Casares,77,54,72,126,edad 70
06147,Carlos Casares,78,55,60,115,edad 70
06147,Carlos Casares,79,34,57,91,edad 70
06147,Carlos Casares,80,45,67,112,edad 80
06147,Carlos Casares,81,29,60,89,edad 80
06147,Carlos Casares,82,31,58,89,edad 80
06147,Carlos Casares,83,24,42,66,edad 80
06147,Carlos Casares,84,31,53,84,edad 80
06147,Carlos Casares,85,21,47,68,edad 80
06147,Carlos Casares,86,16,45,61,edad 80
06147,Carlos Casares,87,12,30,42,edad 80
06147,Carlos Casares,88,16,30,46,edad 80
06147,Carlos Casares,89,10,15,25,edad 80
06147,Carlos Casares,90,7,9,16,edad 90
06147,Carlos Casares,91,4,8,12,edad 90
06147,Carlos Casares,92,7,7,14,edad 90
06147,Carlos Casares,93,2,4,6,edad 90
06147,Carlos Casares,94,0,7,7,edad 90
06147,Carlos Casares,95,2,4,6,edad 90
06147,Carlos Casares,96,1,3,4,edad 90
06147,Carlos Casares,97,1,1,2,edad 90
06147,Carlos Casares,98,0,2,2,edad 90
06147,Carlos Casares,99,1,1,2,edad 90
06154,Carlos Tejedor,0,102,107,209,edad 0
06154,Carlos Tejedor,1,96,87,183,edad 0
06154,Carlos Tejedor,2,99,90,189,edad 0
06154,Carlos Tejedor,3,111,84,195,edad 0
06154,Carlos Tejedor,4,101,101,202,edad 0
06154,Carlos Tejedor,5,105,110,215,edad 0
06154,Carlos Tejedor,6,100,104,204,edad 0
06154,Carlos Tejedor,7,98,91,189,edad 0
06154,Carlos Tejedor,8,96,86,182,edad 0
06154,Carlos Tejedor,9,93,95,188,edad 0
06154,Carlos Tejedor,10,89,113,202,edad 10
06154,Carlos Tejedor,11,103,116,219,edad 10
06154,Carlos Tejedor,12,93,101,194,edad 10
06154,Carlos Tejedor,13,95,93,188,edad 10
06154,Carlos Tejedor,14,85,89,174,edad 10
06154,Carlos Tejedor,15,103,105,208,edad 10
06154,Carlos Tejedor,16,84,103,187,edad 10
06154,Carlos Tejedor,17,97,105,202,edad 10
06154,Carlos Tejedor,18,84,83,167,edad 10
06154,Carlos Tejedor,19,73,63,136,edad 10
06154,Carlos Tejedor,20,89,70,159,edad 20
06154,Carlos Tejedor,21,94,67,161,edad 20
06154,Carlos Tejedor,22,92,70,162,edad 20
06154,Carlos Tejedor,23,73,76,149,edad 20
06154,Carlos Tejedor,24,84,73,157,edad 20
06154,Carlos Tejedor,25,88,84,172,edad 20
06154,Carlos Tejedor,26,81,78,159,edad 20
06154,Carlos Tejedor,27,86,75,161,edad 20
06154,Carlos Tejedor,28,98,76,174,edad 20
06154,Carlos Tejedor,29,70,77,147,edad 20
06154,Carlos Tejedor,30,79,73,152,edad 30
06154,Carlos Tejedor,31,86,65,151,edad 30
06154,Carlos Tejedor,32,69,55,124,edad 30
06154,Carlos Tejedor,33,74,73,147,edad 30
06154,Carlos Tejedor,34,76,69,145,edad 30
06154,Carlos Tejedor,35,66,65,131,edad 30
06154,Carlos Tejedor,36,80,56,136,edad 30
06154,Carlos Tejedor,37,59,65,124,edad 30
06154,Carlos Tejedor,38,63,70,133,edad 30
06154,Carlos Tejedor,39,55,52,107,edad 30
06154,Carlos Tejedor,40,59,93,152,edad 40
06154,Carlos Tejedor,41,58,53,111,edad 40
06154,Carlos Tejedor,42,77,72,149,edad 40
06154,Carlos Tejedor,43,59,66,125,edad 40
06154,Carlos Tejedor,44,46,52,98,edad 40
06154,Carlos Tejedor,45,72,59,131,edad 40
06154,Carlos Tejedor,46,68,60,128,edad 40
06154,Carlos Tejedor,47,77,53,130,edad 40
06154,Carlos Tejedor,48,68,57,125,edad 40
06154,Carlos Tejedor,49,65,50,115,edad 40
06154,Carlos Tejedor,50,56,90,146,edad 50
06154,Carlos Tejedor,51,84,63,147,edad 50
06154,Carlos Tejedor,52,73,74,147,edad 50
06154,Carlos Tejedor,53,76,73,149,edad 50
06154,Carlos Tejedor,54,62,57,119,edad 50
06154,Carlos Tejedor,55,80,63,143,edad 50
06154,Carlos Tejedor,56,63,77,140,edad 50
06154,Carlos Tejedor,57,67,50,117,edad 50
06154,Carlos Tejedor,58,56,67,123,edad 50
06154,Carlos Tejedor,59,65,45,110,edad 50
06154,Carlos Tejedor,60,57,60,117,edad 60
06154,Carlos Tejedor,61,62,58,120,edad 60
06154,Carlos Tejedor,62,46,54,100,edad 60
06154,Carlos Tejedor,63,43,51,94,edad 60
06154,Carlos Tejedor,64,55,54,109,edad 60
06154,Carlos Tejedor,65,53,58,111,edad 60
06154,Carlos Tejedor,66,46,44,90,edad 60
06154,Carlos Tejedor,67,52,41,93,edad 60
06154,Carlos Tejedor,68,57,43,100,edad 60
06154,Carlos Tejedor,69,41,47,88,edad 60
06154,Carlos Tejedor,70,39,41,80,edad 70
06154,Carlos Tejedor,71,39,42,81,edad 70
06154,Carlos Tejedor,72,40,29,69,edad 70
06154,Carlos Tejedor,73,38,38,76,edad 70
06154,Carlos Tejedor,74,44,38,82,edad 70
06154,Carlos Tejedor,75,35,46,81,edad 70
06154,Carlos Tejedor,76,32,29,61,edad 70
06154,Carlos Tejedor,77,29,31,60,edad 70
06154,Carlos Tejedor,78,27,44,71,edad 70
06154,Carlos Tejedor,79,26,28,54,edad 70
06154,Carlos Tejedor,80,21,37,58,edad 80
06154,Carlos Tejedor,81,26,33,59,edad 80
06154,Carlos Tejedor,82,25,32,57,edad 80
06154,Carlos Tejedor,83,9,17,26,edad 80
06154,Carlos Tejedor,84,12,26,38,edad 80
06154,Carlos Tejedor,85,11,26,37,edad 80
06154,Carlos Tejedor,86,9,21,30,edad 80
06154,Carlos Tejedor,87,6,16,22,edad 80
06154,Carlos Tejedor,88,11,14,25,edad 80
06154,Carlos Tejedor,89,6,8,14,edad 80
06154,Carlos Tejedor,90,1,7,8,edad 90
06154,Carlos Tejedor,91,4,9,13,edad 90
06154,Carlos Tejedor,92,4,4,8,edad 90
06154,Carlos Tejedor,93,3,2,5,edad 90
06154,Carlos Tejedor,94,0,4,4,edad 90
06154,Carlos Tejedor,95,4,0,4,edad 90
06154,Carlos Tejedor,96,0,1,1,edad 90
06154,Carlos Tejedor,97,1,2,3,edad 90
06154,Carlos Tejedor,99,0,1,1,edad 90
06161,Carmen de Areco,0,140,128,268,edad 0
06161,Carmen de Areco,1,127,105,232,edad 0
06161,Carmen de Areco,2,136,124,260,edad 0
06161,Carmen de Areco,3,116,108,224,edad 0
06161,Carmen de Areco,4,109,113,222,edad 0
06161,Carmen de Areco,5,112,116,228,edad 0
06161,Carmen de Areco,6,105,106,211,edad 0
06161,Carmen de Areco,7,119,115,234,edad 0
06161,Carmen de Areco,8,119,108,227,edad 0
06161,Carmen de Areco,9,131,137,268,edad 0
06161,Carmen de Areco,10,127,133,260,edad 10
06161,Carmen de Areco,11,130,108,238,edad 10
06161,Carmen de Areco,12,129,123,252,edad 10
06161,Carmen de Areco,13,142,116,258,edad 10
06161,Carmen de Areco,14,112,145,257,edad 10
06161,Carmen de Areco,15,129,130,259,edad 10
06161,Carmen de Areco,16,108,127,235,edad 10
06161,Carmen de Areco,17,131,103,234,edad 10
06161,Carmen de Areco,18,130,117,247,edad 10
06161,Carmen de Areco,19,120,126,246,edad 10
06161,Carmen de Areco,20,117,116,233,edad 20
06161,Carmen de Areco,21,116,113,229,edad 20
06161,Carmen de Areco,22,117,126,243,edad 20
06161,Carmen de Areco,23,125,113,238,edad 20
06161,Carmen de Areco,24,114,104,218,edad 20
06161,Carmen de Areco,25,85,99,184,edad 20
06161,Carmen de Areco,26,101,94,195,edad 20
06161,Carmen de Areco,27,96,87,183,edad 20
06161,Carmen de Areco,28,100,89,189,edad 20
06161,Carmen de Areco,29,96,93,189,edad 20
06161,Carmen de Areco,30,93,86,179,edad 30
06161,Carmen de Areco,31,74,96,170,edad 30
06161,Carmen de Areco,32,78,85,163,edad 30
06161,Carmen de Areco,33,90,80,170,edad 30
06161,Carmen de Areco,34,77,88,165,edad 30
06161,Carmen de Areco,35,98,93,191,edad 30
06161,Carmen de Areco,36,99,96,195,edad 30
06161,Carmen de Areco,37,75,83,158,edad 30
06161,Carmen de Areco,38,99,102,201,edad 30
06161,Carmen de Areco,39,77,76,153,edad 30
06161,Carmen de Areco,40,72,81,153,edad 40
06161,Carmen de Areco,41,86,96,182,edad 40
06161,Carmen de Areco,42,91,91,182,edad 40
06161,Carmen de Areco,43,98,67,165,edad 40
06161,Carmen de Areco,44,76,75,151,edad 40
06161,Carmen de Areco,45,87,91,178,edad 40
06161,Carmen de Areco,46,104,71,175,edad 40
06161,Carmen de Areco,47,74,80,154,edad 40
06161,Carmen de Areco,48,84,74,158,edad 40
06161,Carmen de Areco,49,88,81,169,edad 40
06161,Carmen de Areco,50,82,79,161,edad 50
06161,Carmen de Areco,51,70,80,150,edad 50
06161,Carmen de Areco,52,81,97,178,edad 50
06161,Carmen de Areco,53,73,74,147,edad 50
06161,Carmen de Areco,54,76,76,152,edad 50
06161,Carmen de Areco,55,60,63,123,edad 50
06161,Carmen de Areco,56,76,69,145,edad 50
06161,Carmen de Areco,57,69,56,125,edad 50
06161,Carmen de Areco,58,68,68,136,edad 50
06161,Carmen de Areco,59,54,43,97,edad 50
06161,Carmen de Areco,60,67,57,124,edad 60
06161,Carmen de Areco,61,59,61,120,edad 60
06161,Carmen de Areco,62,60,62,122,edad 60
06161,Carmen de Areco,63,48,54,102,edad 60
06161,Carmen de Areco,64,46,60,106,edad 60
06161,Carmen de Areco,65,56,51,107,edad 60
06161,Carmen de Areco,66,43,35,78,edad 60
06161,Carmen de Areco,67,49,49,98,edad 60
06161,Carmen de Areco,68,51,60,111,edad 60
06161,Carmen de Areco,69,46,37,83,edad 60
06161,Carmen de Areco,70,40,50,90,edad 70
06161,Carmen de Areco,71,35,58,93,edad 70
06161,Carmen de Areco,72,32,46,78,edad 70
06161,Carmen de Areco,73,40,53,93,edad 70
06161,Carmen de Areco,74,42,37,79,edad 70
06161,Carmen de Areco,75,37,49,86,edad 70
06161,Carmen de Areco,76,32,44,76,edad 70
06161,Carmen de Areco,77,34,31,65,edad 70
06161,Carmen de Areco,78,27,31,58,edad 70
06161,Carmen de Areco,79,12,27,39,edad 70
06161,Carmen de Areco,80,15,39,54,edad 80
06161,Carmen de Areco,81,17,36,53,edad 80
06161,Carmen de Areco,82,10,28,38,edad 80
06161,Carmen de Areco,83,23,23,46,edad 80
06161,Carmen de Areco,84,8,28,36,edad 80
06161,Carmen de Areco,85,9,18,27,edad 80
06161,Carmen de Areco,86,10,20,30,edad 80
06161,Carmen de Areco,87,11,25,36,edad 80
06161,Carmen de Areco,88,4,13,17,edad 80
06161,Carmen de Areco,89,3,11,14,edad 80
06161,Carmen de Areco,90,6,6,12,edad 90
06161,Carmen de Areco,91,1,6,7,edad 90
06161,Carmen de Areco,92,2,9,11,edad 90
06161,Carmen de Areco,93,0,3,3,edad 90
06161,Carmen de Areco,94,2,3,5,edad 90
06161,Carmen de Areco,95,2,0,2,edad 90
06161,Carmen de Areco,96,1,5,6,edad 90
06168,Castelli,0,61,76,137,edad 0
06168,Castelli,1,71,63,134,edad 0
06168,Castelli,2,66,76,142,edad 0
06168,Castelli,3,73,58,131,edad 0
06168,Castelli,4,70,74,144,edad 0
06168,Castelli,5,74,59,133,edad 0
06168,Castelli,6,66,57,123,edad 0
06168,Castelli,7,71,74,145,edad 0
06168,Castelli,8,57,70,127,edad 0
06168,Castelli,9,77,70,147,edad 0
06168,Castelli,10,74,67,141,edad 10
06168,Castelli,11,78,63,141,edad 10
06168,Castelli,12,53,67,120,edad 10
06168,Castelli,13,76,68,144,edad 10
06168,Castelli,14,66,65,131,edad 10
06168,Castelli,15,63,52,115,edad 10
06168,Castelli,16,70,56,126,edad 10
06168,Castelli,17,66,57,123,edad 10
06168,Castelli,18,55,67,122,edad 10
06168,Castelli,19,64,56,120,edad 10
06168,Castelli,20,55,52,107,edad 20
06168,Castelli,21,54,67,121,edad 20
06168,Castelli,22,49,70,119,edad 20
06168,Castelli,23,60,69,129,edad 20
06168,Castelli,24,53,65,118,edad 20
06168,Castelli,25,69,49,118,edad 20
06168,Castelli,26,54,65,119,edad 20
06168,Castelli,27,54,57,111,edad 20
06168,Castelli,28,45,53,98,edad 20
06168,Castelli,29,45,44,89,edad 20
06168,Castelli,30,49,55,104,edad 30
06168,Castelli,31,53,67,120,edad 30
06168,Castelli,32,58,46,104,edad 30
06168,Castelli,33,45,56,101,edad 30
06168,Castelli,34,49,53,102,edad 30
06168,Castelli,35,53,42,95,edad 30
06168,Castelli,36,39,51,90,edad 30
06168,Castelli,37,65,42,107,edad 30
06168,Castelli,38,45,39,84,edad 30
06168,Castelli,39,45,45,90,edad 30
06168,Castelli,40,48,45,93,edad 40
06168,Castelli,41,45,47,92,edad 40
06168,Castelli,42,63,51,114,edad 40
06168,Castelli,43,50,41,91,edad 40
06168,Castelli,44,41,42,83,edad 40
06168,Castelli,45,48,47,95,edad 40
06168,Castelli,46,36,40,76,edad 40
06168,Castelli,47,51,40,91,edad 40
06168,Castelli,48,33,44,77,edad 40
06168,Castelli,49,45,39,84,edad 40
06168,Castelli,50,46,38,84,edad 50
06168,Castelli,51,42,39,81,edad 50
06168,Castelli,52,44,38,82,edad 50
06168,Castelli,53,42,41,83,edad 50
06168,Castelli,54,36,44,80,edad 50
06168,Castelli,55,39,33,72,edad 50
06168,Castelli,56,42,38,80,edad 50
06168,Castelli,57,42,32,74,edad 50
06168,Castelli,58,42,35,77,edad 50
06168,Castelli,59,37,33,70,edad 50
06168,Castelli,60,41,42,83,edad 60
06168,Castelli,61,37,33,70,edad 60
06168,Castelli,62,29,38,67,edad 60
06168,Castelli,63,31,43,74,edad 60
06168,Castelli,64,30,25,55,edad 60
06168,Castelli,65,44,34,78,edad 60
06168,Castelli,66,27,29,56,edad 60
06168,Castelli,67,38,31,69,edad 60
06168,Castelli,68,32,34,66,edad 60
06168,Castelli,69,26,27,53,edad 60
06168,Castelli,70,29,44,73,edad 70
06168,Castelli,71,23,38,61,edad 70
06168,Castelli,72,26,21,47,edad 70
06168,Castelli,73,22,33,55,edad 70
06168,Castelli,74,26,25,51,edad 70
06168,Castelli,75,34,29,63,edad 70
06168,Castelli,76,21,19,40,edad 70
06168,Castelli,77,20,21,41,edad 70
06168,Castelli,78,18,20,38,edad 70
06168,Castelli,79,9,19,28,edad 70
06168,Castelli,80,13,20,33,edad 80
06168,Castelli,81,9,18,27,edad 80
06168,Castelli,82,9,23,32,edad 80
06168,Castelli,83,6,13,19,edad 80
06168,Castelli,84,11,14,25,edad 80
06168,Castelli,85,6,8,14,edad 80
06168,Castelli,86,2,11,13,edad 80
06168,Castelli,87,3,7,10,edad 80
06168,Castelli,88,6,9,15,edad 80
06168,Castelli,89,3,7,10,edad 80
06168,Castelli,90,5,3,8,edad 90
06168,Castelli,91,2,3,5,edad 90
06168,Castelli,92,1,5,6,edad 90
06168,Castelli,93,0,5,5,edad 90
06168,Castelli,94,0,4,4,edad 90
06168,Castelli,95,0,3,3,edad 90
06168,Castelli,96,0,1,1,edad 90
06168,Castelli,98,1,2,3,edad 90
06175,Colón,0,183,207,390,edad 0
06175,Colón,1,186,167,353,edad 0
06175,Colón,2,206,192,398,edad 0
06175,Colón,3,190,198,388,edad 0
06175,Colón,4,218,183,401,edad 0
06175,Colón,5,229,199,428,edad 0
06175,Colón,6,215,189,404,edad 0
06175,Colón,7,189,205,394,edad 0
06175,Colón,8,179,209,388,edad 0
06175,Colón,9,169,234,403,edad 0
06175,Colón,10,219,202,421,edad 10
06175,Colón,11,232,227,459,edad 10
06175,Colón,12,242,186,428,edad 10
06175,Colón,13,202,221,423,edad 10
06175,Colón,14,199,184,383,edad 10
06175,Colón,15,210,202,412,edad 10
06175,Colón,16,185,191,376,edad 10
06175,Colón,17,186,201,387,edad 10
06175,Colón,18,214,178,392,edad 10
06175,Colón,19,173,196,369,edad 10
06175,Colón,20,166,170,336,edad 20
06175,Colón,21,192,174,366,edad 20
06175,Colón,22,171,145,316,edad 20
06175,Colón,23,142,157,299,edad 20
06175,Colón,24,177,158,335,edad 20
06175,Colón,25,118,164,282,edad 20
06175,Colón,26,152,156,308,edad 20
06175,Colón,27,138,136,274,edad 20
06175,Colón,28,151,129,280,edad 20
06175,Colón,29,138,139,277,edad 20
06175,Colón,30,164,157,321,edad 30
06175,Colón,31,155,159,314,edad 30
06175,Colón,32,122,165,287,edad 30
06175,Colón,33,140,131,271,edad 30
06175,Colón,34,135,132,267,edad 30
06175,Colón,35,141,153,294,edad 30
06175,Colón,36,148,159,307,edad 30
06175,Colón,37,157,166,323,edad 30
06175,Colón,38,151,171,322,edad 30
06175,Colón,39,127,152,279,edad 30
06175,Colón,40,149,154,303,edad 40
06175,Colón,41,152,132,284,edad 40
06175,Colón,42,149,133,282,edad 40
06175,Colón,43,138,141,279,edad 40
06175,Colón,44,151,135,286,edad 40
06175,Colón,45,129,152,281,edad 40
06175,Colón,46,132,137,269,edad 40
06175,Colón,47,142,118,260,edad 40
06175,Colón,48,136,128,264,edad 40
06175,Colón,49,133,138,271,edad 40
06175,Colón,50,139,145,284,edad 50
06175,Colón,51,133,129,262,edad 50
06175,Colón,52,111,118,229,edad 50
06175,Colón,53,110,132,242,edad 50
06175,Colón,54,113,129,242,edad 50
06175,Colón,55,103,110,213,edad 50
06175,Colón,56,121,131,252,edad 50
06175,Colón,57,106,106,212,edad 50
06175,Colón,58,96,128,224,edad 50
06175,Colón,59,98,91,189,edad 50
06175,Colón,60,103,112,215,edad 60
06175,Colón,61,94,105,199,edad 60
06175,Colón,62,98,102,200,edad 60
06175,Colón,63,90,117,207,edad 60
06175,Colón,64,92,98,190,edad 60
06175,Colón,65,96,100,196,edad 60
06175,Colón,66,102,105,207,edad 60
06175,Colón,67,69,77,146,edad 60
06175,Colón,68,82,91,173,edad 60
06175,Colón,69,77,93,170,edad 60
06175,Colón,70,82,107,189,edad 70
06175,Colón,71,64,91,155,edad 70
06175,Colón,72,66,112,178,edad 70
06175,Colón,73,64,94,158,edad 70
06175,Colón,74,66,82,148,edad 70
06175,Colón,75,71,85,156,edad 70
06175,Colón,76,64,77,141,edad 70
06175,Colón,77,51,72,123,edad 70
06175,Colón,78,40,63,103,edad 70
06175,Colón,79,42,59,101,edad 70
06175,Colón,80,27,41,68,edad 80
06175,Colón,81,38,47,85,edad 80
06175,Colón,82,29,49,78,edad 80
06175,Colón,83,26,49,75,edad 80
06175,Colón,84,10,40,50,edad 80
06175,Colón,85,19,31,50,edad 80
06175,Colón,86,16,43,59,edad 80
06175,Colón,87,14,29,43,edad 80
06175,Colón,88,14,26,40,edad 80
06175,Colón,89,9,25,34,edad 80
06175,Colón,90,4,4,8,edad 90
06175,Colón,91,3,6,9,edad 90
06175,Colón,92,6,8,14,edad 90
06175,Colón,93,2,5,7,edad 90
06175,Colón,94,1,5,6,edad 90
06175,Colón,95,1,3,4,edad 90
06175,Colón,96,0,3,3,edad 90
06175,Colón,97,0,3,3,edad 90
06175,Colón,98,0,1,1,edad 90
06175,Colón,99,0,1,1,edad 90
06182,Coronel de Marina L. Rosales,0,513,534,1047,edad 0
06182,Coronel de Marina L. Rosales,1,544,482,1026,edad 0
06182,Coronel de Marina L. Rosales,2,534,534,1068,edad 0
06182,Coronel de Marina L. Rosales,3,525,524,1049,edad 0
06182,Coronel de Marina L. Rosales,4,541,510,1051,edad 0
06182,Coronel de Marina L. Rosales,5,585,514,1099,edad 0
06182,Coronel de Marina L. Rosales,6,573,525,1098,edad 0
06182,Coronel de Marina L. Rosales,7,549,527,1076,edad 0
06182,Coronel de Marina L. Rosales,8,524,506,1030,edad 0
06182,Coronel de Marina L. Rosales,9,547,539,1086,edad 0
06182,Coronel de Marina L. Rosales,10,606,558,1164,edad 10
06182,Coronel de Marina L. Rosales,11,586,559,1145,edad 10
06182,Coronel de Marina L. Rosales,12,573,542,1115,edad 10
06182,Coronel de Marina L. Rosales,13,585,510,1095,edad 10
06182,Coronel de Marina L. Rosales,14,517,545,1062,edad 10
06182,Coronel de Marina L. Rosales,15,528,531,1059,edad 10
06182,Coronel de Marina L. Rosales,16,528,508,1036,edad 10
06182,Coronel de Marina L. Rosales,17,510,578,1088,edad 10
06182,Coronel de Marina L. Rosales,18,550,500,1050,edad 10
06182,Coronel de Marina L. Rosales,19,560,505,1065,edad 10
06182,Coronel de Marina L. Rosales,20,553,533,1086,edad 20
06182,Coronel de Marina L. Rosales,21,617,542,1159,edad 20
06182,Coronel de Marina L. Rosales,22,574,540,1114,edad 20
06182,Coronel de Marina L. Rosales,23,568,522,1090,edad 20
06182,Coronel de Marina L. Rosales,24,613,521,1134,edad 20
06182,Coronel de Marina L. Rosales,25,566,506,1072,edad 20
06182,Coronel de Marina L. Rosales,26,509,467,976,edad 20
06182,Coronel de Marina L. Rosales,27,527,490,1017,edad 20
06182,Coronel de Marina L. Rosales,28,510,458,968,edad 20
06182,Coronel de Marina L. Rosales,29,510,426,936,edad 20
06182,Coronel de Marina L. Rosales,30,523,424,947,edad 30
06182,Coronel de Marina L. Rosales,31,438,410,848,edad 30
06182,Coronel de Marina L. Rosales,32,413,379,792,edad 30
06182,Coronel de Marina L. Rosales,33,359,387,746,edad 30
06182,Coronel de Marina L. Rosales,34,384,377,761,edad 30
06182,Coronel de Marina L. Rosales,35,345,339,684,edad 30
06182,Coronel de Marina L. Rosales,36,336,399,735,edad 30
06182,Coronel de Marina L. Rosales,37,386,369,755,edad 30
06182,Coronel de Marina L. Rosales,38,343,351,694,edad 30
06182,Coronel de Marina L. Rosales,39,355,340,695,edad 30
06182,Coronel de Marina L. Rosales,40,382,367,749,edad 40
06182,Coronel de Marina L. Rosales,41,362,342,704,edad 40
06182,Coronel de Marina L. Rosales,42,342,340,682,edad 40
06182,Coronel de Marina L. Rosales,43,347,397,744,edad 40
06182,Coronel de Marina L. Rosales,44,327,313,640,edad 40
06182,Coronel de Marina L. Rosales,45,328,374,702,edad 40
06182,Coronel de Marina L. Rosales,46,346,350,696,edad 40
06182,Coronel de Marina L. Rosales,47,311,370,681,edad 40
06182,Coronel de Marina L. Rosales,48,298,333,631,edad 40
06182,Coronel de Marina L. Rosales,49,300,319,619,edad 40
06182,Coronel de Marina L. Rosales,50,369,329,698,edad 50
06182,Coronel de Marina L. Rosales,51,349,320,669,edad 50
06182,Coronel de Marina L. Rosales,52,332,348,680,edad 50
06182,Coronel de Marina L. Rosales,53,302,336,638,edad 50
06182,Coronel de Marina L. Rosales,54,262,305,567,edad 50
06182,Coronel de Marina L. Rosales,55,254,304,558,edad 50
06182,Coronel de Marina L. Rosales,56,291,291,582,edad 50
06182,Coronel de Marina L. Rosales,57,247,236,483,edad 50
06182,Coronel de Marina L. Rosales,58,250,245,495,edad 50
06182,Coronel de Marina L. Rosales,59,221,258,479,edad 50
06182,Coronel de Marina L. Rosales,60,226,258,484,edad 60
06182,Coronel de Marina L. Rosales,61,216,233,449,edad 60
06182,Coronel de Marina L. Rosales,62,211,210,421,edad 60
06182,Coronel de Marina L. Rosales,63,188,224,412,edad 60
06182,Coronel de Marina L. Rosales,64,175,215,390,edad 60
06182,Coronel de Marina L. Rosales,65,174,231,405,edad 60
06182,Coronel de Marina L. Rosales,66,216,197,413,edad 60
06182,Coronel de Marina L. Rosales,67,175,196,371,edad 60
06182,Coronel de Marina L. Rosales,68,154,204,358,edad 60
06182,Coronel de Marina L. Rosales,69,171,200,371,edad 60
06182,Coronel de Marina L. Rosales,70,190,211,401,edad 70
06182,Coronel de Marina L. Rosales,71,146,191,337,edad 70
06182,Coronel de Marina L. Rosales,72,136,210,346,edad 70
06182,Coronel de Marina L. Rosales,73,121,189,310,edad 70
06182,Coronel de Marina L. Rosales,74,141,183,324,edad 70
06182,Coronel de Marina L. Rosales,75,110,194,304,edad 70
06182,Coronel de Marina L. Rosales,76,90,181,271,edad 70
06182,Coronel de Marina L. Rosales,77,107,173,280,edad 70
06182,Coronel de Marina L. Rosales,78,115,148,263,edad 70
06182,Coronel de Marina L. Rosales,79,77,137,214,edad 70
06182,Coronel de Marina L. Rosales,80,81,142,223,edad 80
06182,Coronel de Marina L. Rosales,81,67,87,154,edad 80
06182,Coronel de Marina L. Rosales,82,45,107,152,edad 80
06182,Coronel de Marina L. Rosales,83,52,96,148,edad 80
06182,Coronel de Marina L. Rosales,84,44,99,143,edad 80
06182,Coronel de Marina L. Rosales,85,43,80,123,edad 80
06182,Coronel de Marina L. Rosales,86,32,56,88,edad 80
06182,Coronel de Marina L. Rosales,87,27,54,81,edad 80
06182,Coronel de Marina L. Rosales,88,30,35,65,edad 80
06182,Coronel de Marina L. Rosales,89,11,37,48,edad 80
06182,Coronel de Marina L. Rosales,90,7,28,35,edad 90
06182,Coronel de Marina L. Rosales,91,4,20,24,edad 90
06182,Coronel de Marina L. Rosales,92,2,17,19,edad 90
06182,Coronel de Marina L. Rosales,93,1,21,22,edad 90
06182,Coronel de Marina L. Rosales,94,3,9,12,edad 90
06182,Coronel de Marina L. Rosales,95,1,3,4,edad 90
06182,Coronel de Marina L. Rosales,96,2,4,6,edad 90
06182,Coronel de Marina L. Rosales,97,2,0,2,edad 90
06182,Coronel de Marina L. Rosales,98,1,1,2,edad 90
06182,Coronel de Marina L. Rosales,99,0,1,1,edad 90
06189,Coronel Dorrego,0,121,121,242,edad 0
06189,Coronel Dorrego,1,117,105,222,edad 0
06189,Coronel Dorrego,2,121,109,230,edad 0
06189,Coronel Dorrego,3,137,100,237,edad 0
06189,Coronel Dorrego,4,134,111,245,edad 0
06189,Coronel Dorrego,5,111,126,237,edad 0
06189,Coronel Dorrego,6,132,110,242,edad 0
06189,Coronel Dorrego,7,122,130,252,edad 0
06189,Coronel Dorrego,8,140,128,268,edad 0
06189,Coronel Dorrego,9,135,142,277,edad 0
06189,Coronel Dorrego,10,158,140,298,edad 10
06189,Coronel Dorrego,11,130,141,271,edad 10
06189,Coronel Dorrego,12,145,157,302,edad 10
06189,Coronel Dorrego,13,126,122,248,edad 10
06189,Coronel Dorrego,14,151,144,295,edad 10
06189,Coronel Dorrego,15,128,131,259,edad 10
06189,Coronel Dorrego,16,156,155,311,edad 10
06189,Coronel Dorrego,17,130,132,262,edad 10
06189,Coronel Dorrego,18,147,132,279,edad 10
06189,Coronel Dorrego,19,109,111,220,edad 10
06189,Coronel Dorrego,20,107,115,222,edad 20
06189,Coronel Dorrego,21,122,120,242,edad 20
06189,Coronel Dorrego,22,114,114,228,edad 20
06189,Coronel Dorrego,23,100,113,213,edad 20
06189,Coronel Dorrego,24,103,93,196,edad 20
06189,Coronel Dorrego,25,95,86,181,edad 20
06189,Coronel Dorrego,26,100,89,189,edad 20
06189,Coronel Dorrego,27,95,86,181,edad 20
06189,Coronel Dorrego,28,93,105,198,edad 20
06189,Coronel Dorrego,29,82,103,185,edad 20
06189,Coronel Dorrego,30,94,105,199,edad 30
06189,Coronel Dorrego,31,86,97,183,edad 30
06189,Coronel Dorrego,32,85,93,178,edad 30
06189,Coronel Dorrego,33,106,121,227,edad 30
06189,Coronel Dorrego,34,86,113,199,edad 30
06189,Coronel Dorrego,35,94,92,186,edad 30
06189,Coronel Dorrego,36,99,94,193,edad 30
06189,Coronel Dorrego,37,96,103,199,edad 30
06189,Coronel Dorrego,38,105,110,215,edad 30
06189,Coronel Dorrego,39,104,98,202,edad 30
06189,Coronel Dorrego,40,99,120,219,edad 40
06189,Coronel Dorrego,41,94,96,190,edad 40
06189,Coronel Dorrego,42,89,96,185,edad 40
06189,Coronel Dorrego,43,112,97,209,edad 40
06189,Coronel Dorrego,44,89,81,170,edad 40
06189,Coronel Dorrego,45,102,102,204,edad 40
06189,Coronel Dorrego,46,107,78,185,edad 40
06189,Coronel Dorrego,47,81,88,169,edad 40
06189,Coronel Dorrego,48,101,102,203,edad 40
06189,Coronel Dorrego,49,83,86,169,edad 40
06189,Coronel Dorrego,50,91,97,188,edad 50
06189,Coronel Dorrego,51,96,86,182,edad 50
06189,Coronel Dorrego,52,91,112,203,edad 50
06189,Coronel Dorrego,53,108,95,203,edad 50
06189,Coronel Dorrego,54,97,92,189,edad 50
06189,Coronel Dorrego,55,79,106,185,edad 50
06189,Coronel Dorrego,56,114,107,221,edad 50
06189,Coronel Dorrego,57,87,84,171,edad 50
06189,Coronel Dorrego,58,100,104,204,edad 50
06189,Coronel Dorrego,59,96,73,169,edad 50
06189,Coronel Dorrego,60,75,84,159,edad 60
06189,Coronel Dorrego,61,84,85,169,edad 60
06189,Coronel Dorrego,62,84,83,167,edad 60
06189,Coronel Dorrego,63,69,77,146,edad 60
06189,Coronel Dorrego,64,89,76,165,edad 60
06189,Coronel Dorrego,65,87,100,187,edad 60
06189,Coronel Dorrego,66,63,84,147,edad 60
06189,Coronel Dorrego,67,71,69,140,edad 60
06189,Coronel Dorrego,68,65,86,151,edad 60
06189,Coronel Dorrego,69,55,85,140,edad 60
06189,Coronel Dorrego,70,73,75,148,edad 70
06189,Coronel Dorrego,71,52,89,141,edad 70
06189,Coronel Dorrego,72,70,79,149,edad 70
06189,Coronel Dorrego,73,65,84,149,edad 70
06189,Coronel Dorrego,74,53,84,137,edad 70
06189,Coronel Dorrego,75,66,67,133,edad 70
06189,Coronel Dorrego,76,61,60,121,edad 70
06189,Coronel Dorrego,77,53,64,117,edad 70
06189,Coronel Dorrego,78,48,68,116,edad 70
06189,Coronel Dorrego,79,33,49,82,edad 70
06189,Coronel Dorrego,80,32,61,93,edad 80
06189,Coronel Dorrego,81,33,50,83,edad 80
06189,Coronel Dorrego,82,27,48,75,edad 80
06189,Coronel Dorrego,83,33,40,73,edad 80
06189,Coronel Dorrego,84,19,35,54,edad 80
06189,Coronel Dorrego,85,17,38,55,edad 80
06189,Coronel Dorrego,86,13,35,48,edad 80
06189,Coronel Dorrego,87,13,26,39,edad 80
06189,Coronel Dorrego,88,10,20,30,edad 80
06189,Coronel Dorrego,89,8,13,21,edad 80
06189,Coronel Dorrego,90,7,14,21,edad 90
06189,Coronel Dorrego,91,3,8,11,edad 90
06189,Coronel Dorrego,92,3,2,5,edad 90
06189,Coronel Dorrego,93,0,6,6,edad 90
06189,Coronel Dorrego,94,1,3,4,edad 90
06189,Coronel Dorrego,95,1,2,3,edad 90
06189,Coronel Dorrego,96,0,4,4,edad 90
06189,Coronel Dorrego,97,0,1,1,edad 90
06189,Coronel Dorrego,98,0,1,1,edad 90
06196,Coronel Pringles,0,170,158,328,edad 0
06196,Coronel Pringles,1,184,161,345,edad 0
06196,Coronel Pringles,2,172,187,359,edad 0
06196,Coronel Pringles,3,193,196,389,edad 0
06196,Coronel Pringles,4,193,194,387,edad 0
06196,Coronel Pringles,5,176,204,380,edad 0
06196,Coronel Pringles,6,237,202,439,edad 0
06196,Coronel Pringles,7,212,198,410,edad 0
06196,Coronel Pringles,8,242,224,466,edad 0
06196,Coronel Pringles,9,234,231,465,edad 0
06196,Coronel Pringles,10,255,251,506,edad 10
06196,Coronel Pringles,11,275,203,478,edad 10
06196,Coronel Pringles,12,213,238,451,edad 10
06196,Coronel Pringles,13,227,181,408,edad 10
06196,Coronel Pringles,14,220,235,455,edad 10
06196,Coronel Pringles,15,249,201,450,edad 10
06196,Coronel Pringles,16,199,189,388,edad 10
06196,Coronel Pringles,17,208,165,373,edad 10
06196,Coronel Pringles,18,195,170,365,edad 10
06196,Coronel Pringles,19,166,161,327,edad 10
06196,Coronel Pringles,20,151,165,316,edad 20
06196,Coronel Pringles,21,158,156,314,edad 20
06196,Coronel Pringles,22,179,164,343,edad 20
06196,Coronel Pringles,23,152,150,302,edad 20
06196,Coronel Pringles,24,159,156,315,edad 20
06196,Coronel Pringles,25,144,146,290,edad 20
06196,Coronel Pringles,26,128,148,276,edad 20
06196,Coronel Pringles,27,155,138,293,edad 20
06196,Coronel Pringles,28,137,151,288,edad 20
06196,Coronel Pringles,29,133,139,272,edad 20
06196,Coronel Pringles,30,123,160,283,edad 30
06196,Coronel Pringles,31,162,151,313,edad 30
06196,Coronel Pringles,32,135,142,277,edad 30
06196,Coronel Pringles,33,139,157,296,edad 30
06196,Coronel Pringles,34,136,146,282,edad 30
06196,Coronel Pringles,35,129,159,288,edad 30
06196,Coronel Pringles,36,164,158,322,edad 30
06196,Coronel Pringles,37,157,168,325,edad 30
06196,Coronel Pringles,38,170,125,295,edad 30
06196,Coronel Pringles,39,144,166,310,edad 30
06196,Coronel Pringles,40,156,146,302,edad 40
06196,Coronel Pringles,41,153,155,308,edad 40
06196,Coronel Pringles,42,138,157,295,edad 40
06196,Coronel Pringles,43,129,145,274,edad 40
06196,Coronel Pringles,44,140,130,270,edad 40
06196,Coronel Pringles,45,135,136,271,edad 40
06196,Coronel Pringles,46,135,133,268,edad 40
06196,Coronel Pringles,47,116,144,260,edad 40
06196,Coronel Pringles,48,141,132,273,edad 40
06196,Coronel Pringles,49,113,151,264,edad 40
06196,Coronel Pringles,50,134,153,287,edad 50
06196,Coronel Pringles,51,135,135,270,edad 50
06196,Coronel Pringles,52,138,125,263,edad 50
06196,Coronel Pringles,53,153,146,299,edad 50
06196,Coronel Pringles,54,110,118,228,edad 50
06196,Coronel Pringles,55,111,118,229,edad 50
06196,Coronel Pringles,56,140,122,262,edad 50
06196,Coronel Pringles,57,131,110,241,edad 50
06196,Coronel Pringles,58,114,121,235,edad 50
06196,Coronel Pringles,59,95,115,210,edad 50
06196,Coronel Pringles,60,112,105,217,edad 60
06196,Coronel Pringles,61,101,113,214,edad 60
06196,Coronel Pringles,62,119,89,208,edad 60
06196,Coronel Pringles,63,98,103,201,edad 60
06196,Coronel Pringles,64,95,108,203,edad 60
06196,Coronel Pringles,65,89,98,187,edad 60
06196,Coronel Pringles,66,84,96,180,edad 60
06196,Coronel Pringles,67,90,83,173,edad 60
06196,Coronel Pringles,68,87,86,173,edad 60
06196,Coronel Pringles,69,82,103,185,edad 60
06196,Coronel Pringles,70,91,104,195,edad 70
06196,Coronel Pringles,71,69,104,173,edad 70
06196,Coronel Pringles,72,79,102,181,edad 70
06196,Coronel Pringles,73,78,96,174,edad 70
06196,Coronel Pringles,74,71,78,149,edad 70
06196,Coronel Pringles,75,52,103,155,edad 70
06196,Coronel Pringles,76,65,90,155,edad 70
06196,Coronel Pringles,77,57,67,124,edad 70
06196,Coronel Pringles,78,52,81,133,edad 70
06196,Coronel Pringles,79,53,65,118,edad 70
06196,Coronel Pringles,80,41,77,118,edad 80
06196,Coronel Pringles,81,28,48,76,edad 80
06196,Coronel Pringles,82,35,62,97,edad 80
06196,Coronel Pringles,83,22,70,92,edad 80
06196,Coronel Pringles,84,29,56,85,edad 80
06196,Coronel Pringles,85,21,34,55,edad 80
06196,Coronel Pringles,86,20,42,62,edad 80
06196,Coronel Pringles,87,11,30,41,edad 80
06196,Coronel Pringles,88,6,32,38,edad 80
06196,Coronel Pringles,89,14,22,36,edad 80
06196,Coronel Pringles,90,13,23,36,edad 90
06196,Coronel Pringles,91,9,17,26,edad 90
06196,Coronel Pringles,92,4,12,16,edad 90
06196,Coronel Pringles,93,2,12,14,edad 90
06196,Coronel Pringles,94,2,7,9,edad 90
06196,Coronel Pringles,95,0,2,2,edad 90
06196,Coronel Pringles,96,0,6,6,edad 90
06196,Coronel Pringles,97,1,4,5,edad 90
06196,Coronel Pringles,98,0,2,2,edad 90
06196,Coronel Pringles,99,0,2,2,edad 90
06203,Coronel Suárez,0,265,273,538,edad 0
06203,Coronel Suárez,1,262,229,491,edad 0
06203,Coronel Suárez,2,275,271,546,edad 0
06203,Coronel Suárez,3,265,264,529,edad 0
06203,Coronel Suárez,4,274,284,558,edad 0
06203,Coronel Suárez,5,308,278,586,edad 0
06203,Coronel Suárez,6,310,288,598,edad 0
06203,Coronel Suárez,7,313,297,610,edad 0
06203,Coronel Suárez,8,297,336,633,edad 0
06203,Coronel Suárez,9,355,291,646,edad 0
06203,Coronel Suárez,10,384,317,701,edad 10
06203,Coronel Suárez,11,353,294,647,edad 10
06203,Coronel Suárez,12,343,323,666,edad 10
06203,Coronel Suárez,13,325,305,630,edad 10
06203,Coronel Suárez,14,335,320,655,edad 10
06203,Coronel Suárez,15,350,348,698,edad 10
06203,Coronel Suárez,16,361,333,694,edad 10
06203,Coronel Suárez,17,310,321,631,edad 10
06203,Coronel Suárez,18,299,268,567,edad 10
06203,Coronel Suárez,19,257,248,505,edad 10
06203,Coronel Suárez,20,267,256,523,edad 20
06203,Coronel Suárez,21,250,266,516,edad 20
06203,Coronel Suárez,22,241,205,446,edad 20
06203,Coronel Suárez,23,236,245,481,edad 20
06203,Coronel Suárez,24,217,220,437,edad 20
06203,Coronel Suárez,25,243,238,481,edad 20
06203,Coronel Suárez,26,235,241,476,edad 20
06203,Coronel Suárez,27,240,247,487,edad 20
06203,Coronel Suárez,28,255,246,501,edad 20
06203,Coronel Suárez,29,248,249,497,edad 20
06203,Coronel Suárez,30,252,240,492,edad 30
06203,Coronel Suárez,31,245,251,496,edad 30
06203,Coronel Suárez,32,239,240,479,edad 30
06203,Coronel Suárez,33,235,233,468,edad 30
06203,Coronel Suárez,34,214,217,431,edad 30
06203,Coronel Suárez,35,245,219,464,edad 30
06203,Coronel Suárez,36,235,244,479,edad 30
06203,Coronel Suárez,37,233,267,500,edad 30
06203,Coronel Suárez,38,237,227,464,edad 30
06203,Coronel Suárez,39,190,225,415,edad 30
06203,Coronel Suárez,40,232,236,468,edad 40
06203,Coronel Suárez,41,250,258,508,edad 40
06203,Coronel Suárez,42,231,236,467,edad 40
06203,Coronel Suárez,43,237,254,491,edad 40
06203,Coronel Suárez,44,226,213,439,edad 40
06203,Coronel Suárez,45,234,214,448,edad 40
06203,Coronel Suárez,46,225,218,443,edad 40
06203,Coronel Suárez,47,213,221,434,edad 40
06203,Coronel Suárez,48,222,183,405,edad 40
06203,Coronel Suárez,49,200,204,404,edad 40
06203,Coronel Suárez,50,227,226,453,edad 50
06203,Coronel Suárez,51,217,204,421,edad 50
06203,Coronel Suárez,52,221,214,435,edad 50
06203,Coronel Suárez,53,216,216,432,edad 50
06203,Coronel Suárez,54,198,216,414,edad 50
06203,Coronel Suárez,55,170,229,399,edad 50
06203,Coronel Suárez,56,200,212,412,edad 50
06203,Coronel Suárez,57,184,162,346,edad 50
06203,Coronel Suárez,58,174,192,366,edad 50
06203,Coronel Suárez,59,153,166,319,edad 50
06203,Coronel Suárez,60,176,180,356,edad 60
06203,Coronel Suárez,61,162,148,310,edad 60
06203,Coronel Suárez,62,173,181,354,edad 60
06203,Coronel Suárez,63,158,199,357,edad 60
06203,Coronel Suárez,64,146,159,305,edad 60
06203,Coronel Suárez,65,163,172,335,edad 60
06203,Coronel Suárez,66,158,173,331,edad 60
06203,Coronel Suárez,67,123,163,286,edad 60
06203,Coronel Suárez,68,139,153,292,edad 60
06203,Coronel Suárez,69,120,148,268,edad 60
06203,Coronel Suárez,70,154,158,312,edad 70
06203,Coronel Suárez,71,128,155,283,edad 70
06203,Coronel Suárez,72,123,177,300,edad 70
06203,Coronel Suárez,73,95,131,226,edad 70
06203,Coronel Suárez,74,94,154,248,edad 70
06203,Coronel Suárez,75,102,121,223,edad 70
06203,Coronel Suárez,76,108,124,232,edad 70
06203,Coronel Suárez,77,76,104,180,edad 70
06203,Coronel Suárez,78,72,115,187,edad 70
06203,Coronel Suárez,79,50,97,147,edad 70
06203,Coronel Suárez,80,58,105,163,edad 80
06203,Coronel Suárez,81,56,75,131,edad 80
06203,Coronel Suárez,82,41,88,129,edad 80
06203,Coronel Suárez,83,38,73,111,edad 80
06203,Coronel Suárez,84,39,65,104,edad 80
06203,Coronel Suárez,85,34,65,99,edad 80
06203,Coronel Suárez,86,29,52,81,edad 80
06203,Coronel Suárez,87,23,50,73,edad 80
06203,Coronel Suárez,88,8,44,52,edad 80
06203,Coronel Suárez,89,16,23,39,edad 80
06203,Coronel Suárez,90,8,19,27,edad 90
06203,Coronel Suárez,91,8,22,30,edad 90
06203,Coronel Suárez,92,8,16,24,edad 90
06203,Coronel Suárez,93,6,15,21,edad 90
06203,Coronel Suárez,94,6,14,20,edad 90
06203,Coronel Suárez,95,6,7,13,edad 90
06203,Coronel Suárez,96,4,4,8,edad 90
06203,Coronel Suárez,97,2,1,3,edad 90
06203,Coronel Suárez,98,0,2,2,edad 90
06210,Chacabuco,0,358,318,676,edad 0
06210,Chacabuco,1,347,315,662,edad 0
06210,Chacabuco,2,375,391,766,edad 0
06210,Chacabuco,3,380,367,747,edad 0
06210,Chacabuco,4,365,369,734,edad 0
06210,Chacabuco,5,372,379,751,edad 0
06210,Chacabuco,6,323,362,685,edad 0
06210,Chacabuco,7,371,340,711,edad 0
06210,Chacabuco,8,359,334,693,edad 0
06210,Chacabuco,9,342,383,725,edad 0
06210,Chacabuco,10,369,353,722,edad 10
06210,Chacabuco,11,387,331,718,edad 10
06210,Chacabuco,12,353,349,702,edad 10
06210,Chacabuco,13,338,316,654,edad 10
06210,Chacabuco,14,354,345,699,edad 10
06210,Chacabuco,15,315,349,664,edad 10
06210,Chacabuco,16,335,323,658,edad 10
06210,Chacabuco,17,324,324,648,edad 10
06210,Chacabuco,18,357,332,689,edad 10
06210,Chacabuco,19,331,351,682,edad 10
06210,Chacabuco,20,328,321,649,edad 20
06210,Chacabuco,21,348,345,693,edad 20
06210,Chacabuco,22,356,383,739,edad 20
06210,Chacabuco,23,386,353,739,edad 20
06210,Chacabuco,24,323,346,669,edad 20
06210,Chacabuco,25,352,332,684,edad 20
06210,Chacabuco,26,330,300,630,edad 20
06210,Chacabuco,27,294,322,616,edad 20
06210,Chacabuco,28,320,309,629,edad 20
06210,Chacabuco,29,306,332,638,edad 20
06210,Chacabuco,30,287,297,584,edad 30
06210,Chacabuco,31,284,273,557,edad 30
06210,Chacabuco,32,291,261,552,edad 30
06210,Chacabuco,33,283,266,549,edad 30
06210,Chacabuco,34,225,276,501,edad 30
06210,Chacabuco,35,299,247,546,edad 30
06210,Chacabuco,36,266,303,569,edad 30
06210,Chacabuco,37,270,265,535,edad 30
06210,Chacabuco,38,269,302,571,edad 30
06210,Chacabuco,39,262,258,520,edad 30
06210,Chacabuco,40,262,282,544,edad 40
06210,Chacabuco,41,255,259,514,edad 40
06210,Chacabuco,42,256,276,532,edad 40
06210,Chacabuco,43,262,269,531,edad 40
06210,Chacabuco,44,244,262,506,edad 40
06210,Chacabuco,45,269,257,526,edad 40
06210,Chacabuco,46,266,269,535,edad 40
06210,Chacabuco,47,258,279,537,edad 40
06210,Chacabuco,48,266,267,533,edad 40
06210,Chacabuco,49,229,257,486,edad 40
06210,Chacabuco,50,305,326,631,edad 50
06210,Chacabuco,51,249,287,536,edad 50
06210,Chacabuco,52,295,280,575,edad 50
06210,Chacabuco,53,294,261,555,edad 50
06210,Chacabuco,54,250,269,519,edad 50
06210,Chacabuco,55,239,232,471,edad 50
06210,Chacabuco,56,270,266,536,edad 50
06210,Chacabuco,57,268,261,529,edad 50
06210,Chacabuco,58,217,219,436,edad 50
06210,Chacabuco,59,185,214,399,edad 50
06210,Chacabuco,60,213,250,463,edad 60
06210,Chacabuco,61,212,224,436,edad 60
06210,Chacabuco,62,191,208,399,edad 60
06210,Chacabuco,63,194,228,422,edad 60
06210,Chacabuco,64,192,224,416,edad 60
06210,Chacabuco,65,192,237,429,edad 60
06210,Chacabuco,66,177,182,359,edad 60
06210,Chacabuco,67,179,191,370,edad 60
06210,Chacabuco,68,188,234,422,edad 60
06210,Chacabuco,69,170,203,373,edad 60
06210,Chacabuco,70,188,243,431,edad 70
06210,Chacabuco,71,181,224,405,edad 70
06210,Chacabuco,72,160,224,384,edad 70
06210,Chacabuco,73,173,172,345,edad 70
06210,Chacabuco,74,131,203,334,edad 70
06210,Chacabuco,75,135,155,290,edad 70
06210,Chacabuco,76,128,174,302,edad 70
06210,Chacabuco,77,127,174,301,edad 70
06210,Chacabuco,78,111,154,265,edad 70
06210,Chacabuco,79,87,146,233,edad 70
06210,Chacabuco,80,100,136,236,edad 80
06210,Chacabuco,81,77,101,178,edad 80
06210,Chacabuco,82,65,101,166,edad 80
06210,Chacabuco,83,54,107,161,edad 80
06210,Chacabuco,84,36,79,115,edad 80
06210,Chacabuco,85,42,81,123,edad 80
06210,Chacabuco,86,35,53,88,edad 80
06210,Chacabuco,87,37,68,105,edad 80
06210,Chacabuco,88,23,38,61,edad 80
06210,Chacabuco,89,17,55,72,edad 80
06210,Chacabuco,90,11,32,43,edad 90
06210,Chacabuco,91,9,28,37,edad 90
06210,Chacabuco,92,11,17,28,edad 90
06210,Chacabuco,93,5,7,12,edad 90
06210,Chacabuco,94,3,21,24,edad 90
06210,Chacabuco,95,4,7,11,edad 90
06210,Chacabuco,96,2,5,7,edad 90
06210,Chacabuco,97,1,3,4,edad 90
06210,Chacabuco,98,1,1,2,edad 90
06210,Chacabuco,99,1,1,2,edad 90
06217,Chascomús,0,329,315,644,edad 0
06217,Chascomús,1,315,292,607,edad 0
06217,Chascomús,2,308,328,636,edad 0
06217,Chascomús,3,311,327,638,edad 0
06217,Chascomús,4,344,330,674,edad 0
06217,Chascomús,5,317,314,631,edad 0
06217,Chascomús,6,320,301,621,edad 0
06217,Chascomús,7,337,315,652,edad 0
06217,Chascomús,8,332,291,623,edad 0
06217,Chascomús,9,341,378,719,edad 0
06217,Chascomús,10,395,415,810,edad 10
06217,Chascomús,11,396,360,756,edad 10
06217,Chascomús,12,372,345,717,edad 10
06217,Chascomús,13,363,306,669,edad 10
06217,Chascomús,14,365,345,710,edad 10
06217,Chascomús,15,335,340,675,edad 10
06217,Chascomús,16,371,337,708,edad 10
06217,Chascomús,17,363,300,663,edad 10
06217,Chascomús,18,367,329,696,edad 10
06217,Chascomús,19,375,380,755,edad 10
06217,Chascomús,20,347,370,717,edad 20
06217,Chascomús,21,403,340,743,edad 20
06217,Chascomús,22,347,369,716,edad 20
06217,Chascomús,23,310,302,612,edad 20
06217,Chascomús,24,301,301,602,edad 20
06217,Chascomús,25,267,257,524,edad 20
06217,Chascomús,26,262,270,532,edad 20
06217,Chascomús,27,240,283,523,edad 20
06217,Chascomús,28,250,250,500,edad 20
06217,Chascomús,29,245,264,509,edad 20
06217,Chascomús,30,252,231,483,edad 30
06217,Chascomús,31,242,253,495,edad 30
06217,Chascomús,32,232,217,449,edad 30
06217,Chascomús,33,202,220,422,edad 30
06217,Chascomús,34,196,206,402,edad 30
06217,Chascomús,35,213,213,426,edad 30
06217,Chascomús,36,230,216,446,edad 30
06217,Chascomús,37,223,220,443,edad 30
06217,Chascomús,38,235,259,494,edad 30
06217,Chascomús,39,217,238,455,edad 30
06217,Chascomús,40,210,222,432,edad 40
06217,Chascomús,41,249,228,477,edad 40
06217,Chascomús,42,234,240,474,edad 40
06217,Chascomús,43,224,220,444,edad 40
06217,Chascomús,44,220,204,424,edad 40
06217,Chascomús,45,236,238,474,edad 40
06217,Chascomús,46,207,216,423,edad 40
06217,Chascomús,47,241,251,492,edad 40
06217,Chascomús,48,221,226,447,edad 40
06217,Chascomús,49,187,215,402,edad 40
06217,Chascomús,50,212,238,450,edad 50
06217,Chascomús,51,251,209,460,edad 50
06217,Chascomús,52,233,228,461,edad 50
06217,Chascomús,53,204,224,428,edad 50
06217,Chascomús,54,216,189,405,edad 50
06217,Chascomús,55,170,202,372,edad 50
06217,Chascomús,56,209,199,408,edad 50
06217,Chascomús,57,191,203,394,edad 50
06217,Chascomús,58,171,181,352,edad 50
06217,Chascomús,59,146,154,300,edad 50
06217,Chascomús,60,190,163,353,edad 60
06217,Chascomús,61,147,159,306,edad 60
06217,Chascomús,62,134,181,315,edad 60
06217,Chascomús,63,127,147,274,edad 60
06217,Chascomús,64,141,148,289,edad 60
06217,Chascomús,65,139,162,301,edad 60
06217,Chascomús,66,132,156,288,edad 60
06217,Chascomús,67,126,123,249,edad 60
06217,Chascomús,68,125,154,279,edad 60
06217,Chascomús,69,114,152,266,edad 60
06217,Chascomús,70,120,151,271,edad 70
06217,Chascomús,71,110,131,241,edad 70
06217,Chascomús,72,90,136,226,edad 70
06217,Chascomús,73,75,127,202,edad 70
06217,Chascomús,74,84,123,207,edad 70
06217,Chascomús,75,86,142,228,edad 70
06217,Chascomús,76,73,135,208,edad 70
06217,Chascomús,77,78,117,195,edad 70
06217,Chascomús,78,79,101,180,edad 70
06217,Chascomús,79,51,80,131,edad 70
06217,Chascomús,80,56,83,139,edad 80
06217,Chascomús,81,42,94,136,edad 80
06217,Chascomús,82,48,81,129,edad 80
06217,Chascomús,83,31,72,103,edad 80
06217,Chascomús,84,38,46,84,edad 80
06217,Chascomús,85,23,48,71,edad 80
06217,Chascomús,86,24,52,76,edad 80
06217,Chascomús,87,17,40,57,edad 80
06217,Chascomús,88,14,34,48,edad 80
06217,Chascomús,89,12,47,59,edad 80
06217,Chascomús,90,6,24,30,edad 90
06217,Chascomús,91,7,21,28,edad 90
06217,Chascomús,92,5,14,19,edad 90
06217,Chascomús,93,1,10,11,edad 90
06217,Chascomús,94,3,8,11,edad 90
06217,Chascomús,95,1,8,9,edad 90
06217,Chascomús,96,0,3,3,edad 90
06217,Chascomús,97,0,3,3,edad 90
06217,Chascomús,98,0,2,2,edad 90
06217,Chascomús,99,0,2,2,edad 90
06224,Chivilcoy,0,490,468,958,edad 0
06224,Chivilcoy,1,455,422,877,edad 0
06224,Chivilcoy,2,429,462,891,edad 0
06224,Chivilcoy,3,469,413,882,edad 0
06224,Chivilcoy,4,454,410,864,edad 0
06224,Chivilcoy,5,467,473,940,edad 0
06224,Chivilcoy,6,428,428,856,edad 0
06224,Chivilcoy,7,469,455,924,edad 0
06224,Chivilcoy,8,427,478,905,edad 0
06224,Chivilcoy,9,428,496,924,edad 0
06224,Chivilcoy,10,495,504,999,edad 10
06224,Chivilcoy,11,518,477,995,edad 10
06224,Chivilcoy,12,473,460,933,edad 10
06224,Chivilcoy,13,443,469,912,edad 10
06224,Chivilcoy,14,469,504,973,edad 10
06224,Chivilcoy,15,513,456,969,edad 10
06224,Chivilcoy,16,451,441,892,edad 10
06224,Chivilcoy,17,444,431,875,edad 10
06224,Chivilcoy,18,449,400,849,edad 10
06224,Chivilcoy,19,446,415,861,edad 10
06224,Chivilcoy,20,417,404,821,edad 20
06224,Chivilcoy,21,447,477,924,edad 20
06224,Chivilcoy,22,435,429,864,edad 20
06224,Chivilcoy,23,454,446,900,edad 20
06224,Chivilcoy,24,437,469,906,edad 20
06224,Chivilcoy,25,394,410,804,edad 20
06224,Chivilcoy,26,364,424,788,edad 20
06224,Chivilcoy,27,406,403,809,edad 20
06224,Chivilcoy,28,385,395,780,edad 20
06224,Chivilcoy,29,371,358,729,edad 20
06224,Chivilcoy,30,400,393,793,edad 30
06224,Chivilcoy,31,365,395,760,edad 30
06224,Chivilcoy,32,371,407,778,edad 30
06224,Chivilcoy,33,379,363,742,edad 30
06224,Chivilcoy,34,348,349,697,edad 30
06224,Chivilcoy,35,348,344,692,edad 30
06224,Chivilcoy,36,356,399,755,edad 30
06224,Chivilcoy,37,340,378,718,edad 30
06224,Chivilcoy,38,351,393,744,edad 30
06224,Chivilcoy,39,327,353,680,edad 30
06224,Chivilcoy,40,361,380,741,edad 40
06224,Chivilcoy,41,350,402,752,edad 40
06224,Chivilcoy,42,371,373,744,edad 40
06224,Chivilcoy,43,347,371,718,edad 40
06224,Chivilcoy,44,338,396,734,edad 40
06224,Chivilcoy,45,361,390,751,edad 40
06224,Chivilcoy,46,333,356,689,edad 40
06224,Chivilcoy,47,351,393,744,edad 40
06224,Chivilcoy,48,359,358,717,edad 40
06224,Chivilcoy,49,365,356,721,edad 40
06224,Chivilcoy,50,389,413,802,edad 50
06224,Chivilcoy,51,358,391,749,edad 50
06224,Chivilcoy,52,396,369,765,edad 50
06224,Chivilcoy,53,398,399,797,edad 50
06224,Chivilcoy,54,331,342,673,edad 50
06224,Chivilcoy,55,337,377,714,edad 50
06224,Chivilcoy,56,354,394,748,edad 50
06224,Chivilcoy,57,293,344,637,edad 50
06224,Chivilcoy,58,296,353,649,edad 50
06224,Chivilcoy,59,253,303,556,edad 50
06224,Chivilcoy,60,295,305,600,edad 60
06224,Chivilcoy,61,298,298,596,edad 60
06224,Chivilcoy,62,252,301,553,edad 60
06224,Chivilcoy,63,251,328,579,edad 60
06224,Chivilcoy,64,276,297,573,edad 60
06224,Chivilcoy,65,276,328,604,edad 60
06224,Chivilcoy,66,241,283,524,edad 60
06224,Chivilcoy,67,254,273,527,edad 60
06224,Chivilcoy,68,271,306,577,edad 60
06224,Chivilcoy,69,210,285,495,edad 60
06224,Chivilcoy,70,258,329,587,edad 70
06224,Chivilcoy,71,209,287,496,edad 70
06224,Chivilcoy,72,219,312,531,edad 70
06224,Chivilcoy,73,192,280,472,edad 70
06224,Chivilcoy,74,174,284,458,edad 70
06224,Chivilcoy,75,196,255,451,edad 70
06224,Chivilcoy,76,198,272,470,edad 70
06224,Chivilcoy,77,153,250,403,edad 70
06224,Chivilcoy,78,145,242,387,edad 70
06224,Chivilcoy,79,102,208,310,edad 70
06224,Chivilcoy,80,104,205,309,edad 80
06224,Chivilcoy,81,93,166,259,edad 80
06224,Chivilcoy,82,81,157,238,edad 80
06224,Chivilcoy,83,71,170,241,edad 80
06224,Chivilcoy,84,65,114,179,edad 80
06224,Chivilcoy,85,57,129,186,edad 80
06224,Chivilcoy,86,45,115,160,edad 80
06224,Chivilcoy,87,35,86,121,edad 80
06224,Chivilcoy,88,34,99,133,edad 80
06224,Chivilcoy,89,26,58,84,edad 80
06224,Chivilcoy,90,19,70,89,edad 90
06224,Chivilcoy,91,17,51,68,edad 90
06224,Chivilcoy,92,16,34,50,edad 90
06224,Chivilcoy,93,5,39,44,edad 90
06224,Chivilcoy,94,5,4,9,edad 90
06224,Chivilcoy,95,7,11,18,edad 90
06224,Chivilcoy,96,1,6,7,edad 90
06224,Chivilcoy,97,1,3,4,edad 90
06224,Chivilcoy,98,0,3,3,edad 90
06231,Daireaux,0,137,123,260,edad 0
06231,Daireaux,1,140,134,274,edad 0
06231,Daireaux,2,158,144,302,edad 0
06231,Daireaux,3,136,155,291,edad 0
06231,Daireaux,4,154,158,312,edad 0
06231,Daireaux,5,174,146,320,edad 0
06231,Daireaux,6,169,164,333,edad 0
06231,Daireaux,7,161,131,292,edad 0
06231,Daireaux,8,165,150,315,edad 0
06231,Daireaux,9,156,145,301,edad 0
06231,Daireaux,10,161,165,326,edad 10
06231,Daireaux,11,171,155,326,edad 10
06231,Daireaux,12,163,142,305,edad 10
06231,Daireaux,13,159,165,324,edad 10
06231,Daireaux,14,158,120,278,edad 10
06231,Daireaux,15,140,145,285,edad 10
06231,Daireaux,16,137,158,295,edad 10
06231,Daireaux,17,127,149,276,edad 10
06231,Daireaux,18,125,118,243,edad 10
06231,Daireaux,19,131,117,248,edad 10
06231,Daireaux,20,115,95,210,edad 20
06231,Daireaux,21,121,101,222,edad 20
06231,Daireaux,22,89,102,191,edad 20
06231,Daireaux,23,105,109,214,edad 20
06231,Daireaux,24,105,126,231,edad 20
06231,Daireaux,25,100,110,210,edad 20
06231,Daireaux,26,82,115,197,edad 20
06231,Daireaux,27,99,114,213,edad 20
06231,Daireaux,28,85,93,178,edad 20
06231,Daireaux,29,95,98,193,edad 20
06231,Daireaux,30,112,101,213,edad 30
06231,Daireaux,31,100,96,196,edad 30
06231,Daireaux,32,83,90,173,edad 30
06231,Daireaux,33,83,107,190,edad 30
06231,Daireaux,34,98,86,184,edad 30
06231,Daireaux,35,92,99,191,edad 30
06231,Daireaux,36,110,80,190,edad 30
06231,Daireaux,37,95,113,208,edad 30
06231,Daireaux,38,98,112,210,edad 30
06231,Daireaux,39,92,108,200,edad 30
06231,Daireaux,40,85,94,179,edad 40
06231,Daireaux,41,102,107,209,edad 40
06231,Daireaux,42,117,97,214,edad 40
06231,Daireaux,43,90,87,177,edad 40
06231,Daireaux,44,94,83,177,edad 40
06231,Daireaux,45,81,100,181,edad 40
06231,Daireaux,46,100,90,190,edad 40
06231,Daireaux,47,84,96,180,edad 40
06231,Daireaux,48,82,83,165,edad 40
06231,Daireaux,49,99,86,185,edad 40
06231,Daireaux,50,97,84,181,edad 50
06231,Daireaux,51,104,92,196,edad 50
06231,Daireaux,52,86,109,195,edad 50
06231,Daireaux,53,93,78,171,edad 50
06231,Daireaux,54,70,63,133,edad 50
06231,Daireaux,55,89,80,169,edad 50
06231,Daireaux,56,88,82,170,edad 50
06231,Daireaux,57,66,82,148,edad 50
06231,Daireaux,58,88,62,150,edad 50
06231,Daireaux,59,69,66,135,edad 50
06231,Daireaux,60,76,62,138,edad 60
06231,Daireaux,61,65,77,142,edad 60
06231,Daireaux,62,78,73,151,edad 60
06231,Daireaux,63,45,61,106,edad 60
06231,Daireaux,64,55,62,117,edad 60
06231,Daireaux,65,60,66,126,edad 60
06231,Daireaux,66,67,45,112,edad 60
06231,Daireaux,67,46,45,91,edad 60
06231,Daireaux,68,48,48,96,edad 60
06231,Daireaux,69,38,51,89,edad 60
06231,Daireaux,70,58,54,112,edad 70
06231,Daireaux,71,44,42,86,edad 70
06231,Daireaux,72,46,49,95,edad 70
06231,Daireaux,73,37,57,94,edad 70
06231,Daireaux,74,32,46,78,edad 70
06231,Daireaux,75,35,41,76,edad 70
06231,Daireaux,76,30,47,77,edad 70
06231,Daireaux,77,22,56,78,edad 70
06231,Daireaux,78,29,33,62,edad 70
06231,Daireaux,79,23,46,69,edad 70
06231,Daireaux,80,22,35,57,edad 80
06231,Daireaux,81,21,38,59,edad 80
06231,Daireaux,82,20,32,52,edad 80
06231,Daireaux,83,13,35,48,edad 80
06231,Daireaux,84,16,27,43,edad 80
06231,Daireaux,85,12,19,31,edad 80
06231,Daireaux,86,14,21,35,edad 80
06231,Daireaux,87,9,11,20,edad 80
06231,Daireaux,88,7,11,18,edad 80
06231,Daireaux,89,4,13,17,edad 80
06231,Daireaux,90,4,8,12,edad 90
06231,Daireaux,91,3,16,19,edad 90
06231,Daireaux,92,2,5,7,edad 90
06231,Daireaux,93,2,5,7,edad 90
06231,Daireaux,94,1,3,4,edad 90
06231,Daireaux,95,1,2,3,edad 90
06231,Daireaux,96,3,0,3,edad 90
06231,Daireaux,98,0,1,1,edad 90
06238,Dolores,0,219,218,437,edad 0
06238,Dolores,1,197,173,370,edad 0
06238,Dolores,2,232,222,454,edad 0
06238,Dolores,3,209,227,436,edad 0
06238,Dolores,4,232,195,427,edad 0
06238,Dolores,5,203,227,430,edad 0
06238,Dolores,6,214,224,438,edad 0
06238,Dolores,7,236,198,434,edad 0
06238,Dolores,8,233,196,429,edad 0
06238,Dolores,9,231,232,463,edad 0
06238,Dolores,10,198,237,435,edad 10
06238,Dolores,11,234,241,475,edad 10
06238,Dolores,12,221,231,452,edad 10
06238,Dolores,13,228,192,420,edad 10
06238,Dolores,14,232,202,434,edad 10
06238,Dolores,15,233,175,408,edad 10
06238,Dolores,16,198,197,395,edad 10
06238,Dolores,17,206,242,448,edad 10
06238,Dolores,18,201,204,405,edad 10
06238,Dolores,19,193,202,395,edad 10
06238,Dolores,20,212,185,397,edad 20
06238,Dolores,21,198,214,412,edad 20
06238,Dolores,22,223,213,436,edad 20
06238,Dolores,23,190,199,389,edad 20
06238,Dolores,24,179,197,376,edad 20
06238,Dolores,25,169,148,317,edad 20
06238,Dolores,26,169,150,319,edad 20
06238,Dolores,27,139,171,310,edad 20
06238,Dolores,28,195,160,355,edad 20
06238,Dolores,29,141,164,305,edad 20
06238,Dolores,30,167,166,333,edad 30
06238,Dolores,31,155,164,319,edad 30
06238,Dolores,32,159,170,329,edad 30
06238,Dolores,33,176,171,347,edad 30
06238,Dolores,34,167,135,302,edad 30
06238,Dolores,35,156,167,323,edad 30
06238,Dolores,36,152,163,315,edad 30
06238,Dolores,37,133,166,299,edad 30
06238,Dolores,38,170,158,328,edad 30
06238,Dolores,39,151,154,305,edad 30
06238,Dolores,40,170,169,339,edad 40
06238,Dolores,41,139,152,291,edad 40
06238,Dolores,42,141,168,309,edad 40
06238,Dolores,43,139,141,280,edad 40
06238,Dolores,44,132,156,288,edad 40
06238,Dolores,45,132,155,287,edad 40
06238,Dolores,46,141,145,286,edad 40
06238,Dolores,47,147,117,264,edad 40
06238,Dolores,48,125,163,288,edad 40
06238,Dolores,49,121,153,274,edad 40
06238,Dolores,50,148,155,303,edad 50
06238,Dolores,51,140,137,277,edad 50
06238,Dolores,52,141,170,311,edad 50
06238,Dolores,53,133,151,284,edad 50
06238,Dolores,54,137,117,254,edad 50
06238,Dolores,55,130,114,244,edad 50
06238,Dolores,56,119,162,281,edad 50
06238,Dolores,57,96,104,200,edad 50
06238,Dolores,58,124,128,252,edad 50
06238,Dolores,59,102,128,230,edad 50
06238,Dolores,60,117,131,248,edad 60
06238,Dolores,61,123,109,232,edad 60
06238,Dolores,62,116,95,211,edad 60
06238,Dolores,63,100,111,211,edad 60
06238,Dolores,64,86,100,186,edad 60
06238,Dolores,65,84,105,189,edad 60
06238,Dolores,66,74,108,182,edad 60
06238,Dolores,67,85,107,192,edad 60
06238,Dolores,68,63,100,163,edad 60
06238,Dolores,69,74,101,175,edad 60
06238,Dolores,70,104,123,227,edad 70
06238,Dolores,71,65,94,159,edad 70
06238,Dolores,72,60,104,164,edad 70
06238,Dolores,73,81,85,166,edad 70
06238,Dolores,74,64,95,159,edad 70
06238,Dolores,75,47,103,150,edad 70
06238,Dolores,76,51,84,135,edad 70
06238,Dolores,77,46,81,127,edad 70
06238,Dolores,78,74,82,156,edad 70
06238,Dolores,79,47,75,122,edad 70
06238,Dolores,80,25,73,98,edad 80
06238,Dolores,81,29,59,88,edad 80
06238,Dolores,82,31,47,78,edad 80
06238,Dolores,83,19,46,65,edad 80
06238,Dolores,84,19,38,57,edad 80
06238,Dolores,85,26,47,73,edad 80
06238,Dolores,86,14,36,50,edad 80
06238,Dolores,87,13,34,47,edad 80
06238,Dolores,88,14,19,33,edad 80
06238,Dolores,89,9,27,36,edad 80
06238,Dolores,90,8,24,32,edad 90
06238,Dolores,91,4,14,18,edad 90
06238,Dolores,92,3,12,15,edad 90
06238,Dolores,93,3,6,9,edad 90
06238,Dolores,94,1,3,4,edad 90
06238,Dolores,95,0,1,1,edad 90
06238,Dolores,96,1,6,7,edad 90
06238,Dolores,97,0,3,3,edad 90
06238,Dolores,98,1,0,1,edad 90
06238,Dolores,99,1,1,2,edad 90
06245,Ensenada,0,458,450,908,edad 0
06245,Ensenada,1,425,445,870,edad 0
06245,Ensenada,2,491,475,966,edad 0
06245,Ensenada,3,427,440,867,edad 0
06245,Ensenada,4,456,433,889,edad 0
06245,Ensenada,5,494,484,978,edad 0
06245,Ensenada,6,482,488,970,edad 0
06245,Ensenada,7,508,432,940,edad 0
06245,Ensenada,8,431,407,838,edad 0
06245,Ensenada,9,479,447,926,edad 0
06245,Ensenada,10,513,472,985,edad 10
06245,Ensenada,11,523,490,1013,edad 10
06245,Ensenada,12,461,468,929,edad 10
06245,Ensenada,13,489,489,978,edad 10
06245,Ensenada,14,460,472,932,edad 10
06245,Ensenada,15,460,452,912,edad 10
06245,Ensenada,16,429,422,851,edad 10
06245,Ensenada,17,417,414,831,edad 10
06245,Ensenada,18,502,461,963,edad 10
06245,Ensenada,19,488,466,954,edad 10
06245,Ensenada,20,483,507,990,edad 20
06245,Ensenada,21,471,477,948,edad 20
06245,Ensenada,22,455,452,907,edad 20
06245,Ensenada,23,461,455,916,edad 20
06245,Ensenada,24,445,415,860,edad 20
06245,Ensenada,25,432,363,795,edad 20
06245,Ensenada,26,405,393,798,edad 20
06245,Ensenada,27,374,370,744,edad 20
06245,Ensenada,28,346,343,689,edad 20
06245,Ensenada,29,329,365,694,edad 20
06245,Ensenada,30,362,381,743,edad 30
06245,Ensenada,31,338,329,667,edad 30
06245,Ensenada,32,336,324,660,edad 30
06245,Ensenada,33,273,340,613,edad 30
06245,Ensenada,34,301,314,615,edad 30
06245,Ensenada,35,300,296,596,edad 30
06245,Ensenada,36,312,309,621,edad 30
06245,Ensenada,37,300,324,624,edad 30
06245,Ensenada,38,292,348,640,edad 30
06245,Ensenada,39,293,320,613,edad 30
06245,Ensenada,40,304,327,631,edad 40
06245,Ensenada,41,308,308,616,edad 40
06245,Ensenada,42,346,360,706,edad 40
06245,Ensenada,43,298,319,617,edad 40
06245,Ensenada,44,279,306,585,edad 40
06245,Ensenada,45,328,341,669,edad 40
06245,Ensenada,46,295,326,621,edad 40
06245,Ensenada,47,308,280,588,edad 40
06245,Ensenada,48,295,298,593,edad 40
06245,Ensenada,49,275,267,542,edad 40
06245,Ensenada,50,286,285,571,edad 50
06245,Ensenada,51,278,289,567,edad 50
06245,Ensenada,52,265,254,519,edad 50
06245,Ensenada,53,271,244,515,edad 50
06245,Ensenada,54,220,196,416,edad 50
06245,Ensenada,55,233,240,473,edad 50
06245,Ensenada,56,241,275,516,edad 50
06245,Ensenada,57,216,218,434,edad 50
06245,Ensenada,58,191,213,404,edad 50
06245,Ensenada,59,185,192,377,edad 50
06245,Ensenada,60,183,202,385,edad 60
06245,Ensenada,61,169,218,387,edad 60
06245,Ensenada,62,171,182,353,edad 60
06245,Ensenada,63,175,204,379,edad 60
06245,Ensenada,64,161,169,330,edad 60
06245,Ensenada,65,189,194,383,edad 60
06245,Ensenada,66,169,180,349,edad 60
06245,Ensenada,67,149,183,332,edad 60
06245,Ensenada,68,159,162,321,edad 60
06245,Ensenada,69,128,215,343,edad 60
06245,Ensenada,70,154,195,349,edad 70
06245,Ensenada,71,139,191,330,edad 70
06245,Ensenada,72,106,169,275,edad 70
06245,Ensenada,73,119,180,299,edad 70
06245,Ensenada,74,102,172,274,edad 70
06245,Ensenada,75,114,148,262,edad 70
06245,Ensenada,76,92,163,255,edad 70
06245,Ensenada,77,81,113,194,edad 70
06245,Ensenada,78,64,137,201,edad 70
06245,Ensenada,79,57,135,192,edad 70
06245,Ensenada,80,45,102,147,edad 80
06245,Ensenada,81,43,101,144,edad 80
06245,Ensenada,82,57,78,135,edad 80
06245,Ensenada,83,32,70,102,edad 80
06245,Ensenada,84,37,67,104,edad 80
06245,Ensenada,85,21,46,67,edad 80
06245,Ensenada,86,24,47,71,edad 80
06245,Ensenada,87,17,53,70,edad 80
06245,Ensenada,88,15,32,47,edad 80
06245,Ensenada,89,13,25,38,edad 80
06245,Ensenada,90,5,28,33,edad 90
06245,Ensenada,91,9,26,35,edad 90
06245,Ensenada,92,2,21,23,edad 90
06245,Ensenada,93,6,12,18,edad 90
06245,Ensenada,94,2,10,12,edad 90
06245,Ensenada,95,1,6,7,edad 90
06245,Ensenada,96,2,4,6,edad 90
06245,Ensenada,99,0,2,2,edad 90
06252,Escobar,0,1867,1833,3700,edad 0
06252,Escobar,1,1730,1662,3392,edad 0
06252,Escobar,2,2038,2021,4059,edad 0
06252,Escobar,3,2017,1931,3948,edad 0
06252,Escobar,4,2071,1922,3993,edad 0
06252,Escobar,5,2128,2072,4200,edad 0
06252,Escobar,6,2044,1908,3952,edad 0
06252,Escobar,7,1955,1890,3845,edad 0
06252,Escobar,8,1899,1880,3779,edad 0
06252,Escobar,9,1927,1847,3774,edad 0
06252,Escobar,10,2076,1935,4011,edad 10
06252,Escobar,11,1922,1946,3868,edad 10
06252,Escobar,12,1805,1817,3622,edad 10
06252,Escobar,13,1888,1824,3712,edad 10
06252,Escobar,14,1831,1773,3604,edad 10
06252,Escobar,15,1727,1667,3394,edad 10
06252,Escobar,16,1613,1608,3221,edad 10
06252,Escobar,17,1600,1597,3197,edad 10
06252,Escobar,18,1620,1544,3164,edad 10
06252,Escobar,19,1661,1674,3335,edad 10
06252,Escobar,20,1645,1600,3245,edad 20
06252,Escobar,21,1620,1730,3350,edad 20
06252,Escobar,22,1591,1657,3248,edad 20
06252,Escobar,23,1712,1609,3321,edad 20
06252,Escobar,24,1492,1520,3012,edad 20
06252,Escobar,25,1369,1454,2823,edad 20
06252,Escobar,26,1364,1459,2823,edad 20
06252,Escobar,27,1319,1387,2706,edad 20
06252,Escobar,28,1329,1343,2672,edad 20
06252,Escobar,29,1283,1268,2551,edad 20
06252,Escobar,30,1448,1431,2879,edad 30
06252,Escobar,31,1274,1275,2549,edad 30
06252,Escobar,32,1181,1281,2462,edad 30
06252,Escobar,33,1180,1277,2457,edad 30
06252,Escobar,34,1070,1138,2208,edad 30
06252,Escobar,35,1084,1176,2260,edad 30
06252,Escobar,36,1176,1259,2435,edad 30
06252,Escobar,37,1123,1176,2299,edad 30
06252,Escobar,38,1194,1178,2372,edad 30
06252,Escobar,39,1004,1120,2124,edad 30
06252,Escobar,40,1071,1194,2265,edad 40
06252,Escobar,41,1118,1083,2201,edad 40
06252,Escobar,42,1135,1130,2265,edad 40
06252,Escobar,43,1068,1055,2123,edad 40
06252,Escobar,44,1018,1030,2048,edad 40
06252,Escobar,45,1084,1030,2114,edad 40
06252,Escobar,46,984,953,1937,edad 40
06252,Escobar,47,965,954,1919,edad 40
06252,Escobar,48,938,1024,1962,edad 40
06252,Escobar,49,850,876,1726,edad 40
06252,Escobar,50,964,989,1953,edad 50
06252,Escobar,51,902,874,1776,edad 50
06252,Escobar,52,898,880,1778,edad 50
06252,Escobar,53,802,774,1576,edad 50
06252,Escobar,54,749,753,1502,edad 50
06252,Escobar,55,694,728,1422,edad 50
06252,Escobar,56,723,724,1447,edad 50
06252,Escobar,57,636,601,1237,edad 50
06252,Escobar,58,620,600,1220,edad 50
06252,Escobar,59,543,498,1041,edad 50
06252,Escobar,60,550,617,1167,edad 60
06252,Escobar,61,500,502,1002,edad 60
06252,Escobar,62,444,451,895,edad 60
06252,Escobar,63,371,472,843,edad 60
06252,Escobar,64,471,412,883,edad 60
06252,Escobar,65,427,438,865,edad 60
06252,Escobar,66,319,372,691,edad 60
06252,Escobar,67,337,378,715,edad 60
06252,Escobar,68,335,337,672,edad 60
06252,Escobar,69,299,324,623,edad 60
06252,Escobar,70,304,389,693,edad 70
06252,Escobar,71,262,339,601,edad 70
06252,Escobar,72,277,350,627,edad 70
06252,Escobar,73,229,277,506,edad 70
06252,Escobar,74,222,301,523,edad 70
06252,Escobar,75,207,267,474,edad 70
06252,Escobar,76,191,280,471,edad 70
06252,Escobar,77,141,213,354,edad 70
06252,Escobar,78,146,218,364,edad 70
06252,Escobar,79,107,166,273,edad 70
06252,Escobar,80,99,185,284,edad 80
06252,Escobar,81,98,141,239,edad 80
06252,Escobar,82,92,132,224,edad 80
06252,Escobar,83,59,106,165,edad 80
06252,Escobar,84,47,110,157,edad 80
06252,Escobar,85,44,91,135,edad 80
06252,Escobar,86,33,84,117,edad 80
06252,Escobar,87,20,95,115,edad 80
06252,Escobar,88,32,61,93,edad 80
06252,Escobar,89,20,62,82,edad 80
06252,Escobar,90,19,43,62,edad 90
06252,Escobar,91,20,35,55,edad 90
06252,Escobar,92,5,25,30,edad 90
06252,Escobar,93,5,15,20,edad 90
06252,Escobar,94,15,14,29,edad 90
06252,Escobar,95,5,5,10,edad 90
06252,Escobar,96,3,4,7,edad 90
06252,Escobar,97,3,2,5,edad 90
06252,Escobar,98,1,0,1,edad 90
06252,Escobar,99,0,1,1,edad 90
06266,Exaltación de la Cruz,0,216,236,452,edad 0
06266,Exaltación de la Cruz,1,232,233,465,edad 0
06266,Exaltación de la Cruz,2,221,241,462,edad 0
06266,Exaltación de la Cruz,3,217,220,437,edad 0
06266,Exaltación de la Cruz,4,258,257,515,edad 0
06266,Exaltación de la Cruz,5,267,247,514,edad 0
06266,Exaltación de la Cruz,6,258,236,494,edad 0
06266,Exaltación de la Cruz,7,257,243,500,edad 0
06266,Exaltación de la Cruz,8,243,216,459,edad 0
06266,Exaltación de la Cruz,9,245,245,490,edad 0
06266,Exaltación de la Cruz,10,270,249,519,edad 10
06266,Exaltación de la Cruz,11,256,204,460,edad 10
06266,Exaltación de la Cruz,12,241,222,463,edad 10
06266,Exaltación de la Cruz,13,254,233,487,edad 10
06266,Exaltación de la Cruz,14,226,235,461,edad 10
06266,Exaltación de la Cruz,15,209,200,409,edad 10
06266,Exaltación de la Cruz,16,220,181,401,edad 10
06266,Exaltación de la Cruz,17,196,191,387,edad 10
06266,Exaltación de la Cruz,18,175,200,375,edad 10
06266,Exaltación de la Cruz,19,199,222,421,edad 10
06266,Exaltación de la Cruz,20,188,203,391,edad 20
06266,Exaltación de la Cruz,21,194,207,401,edad 20
06266,Exaltación de la Cruz,22,215,194,409,edad 20
06266,Exaltación de la Cruz,23,193,205,398,edad 20
06266,Exaltación de la Cruz,24,213,187,400,edad 20
06266,Exaltación de la Cruz,25,198,179,377,edad 20
06266,Exaltación de la Cruz,26,176,178,354,edad 20
06266,Exaltación de la Cruz,27,192,161,353,edad 20
06266,Exaltación de la Cruz,28,174,165,339,edad 20
06266,Exaltación de la Cruz,29,155,185,340,edad 20
06266,Exaltación de la Cruz,30,176,174,350,edad 30
06266,Exaltación de la Cruz,31,154,164,318,edad 30
06266,Exaltación de la Cruz,32,191,186,377,edad 30
06266,Exaltación de la Cruz,33,152,174,326,edad 30
06266,Exaltación de la Cruz,34,145,159,304,edad 30
06266,Exaltación de la Cruz,35,151,155,306,edad 30
06266,Exaltación de la Cruz,36,178,156,334,edad 30
06266,Exaltación de la Cruz,37,177,160,337,edad 30
06266,Exaltación de la Cruz,38,157,166,323,edad 30
06266,Exaltación de la Cruz,39,141,131,272,edad 30
06266,Exaltación de la Cruz,40,147,137,284,edad 40
06266,Exaltación de la Cruz,41,178,134,312,edad 40
06266,Exaltación de la Cruz,42,142,158,300,edad 40
06266,Exaltación de la Cruz,43,171,123,294,edad 40
06266,Exaltación de la Cruz,44,134,134,268,edad 40
06266,Exaltación de la Cruz,45,134,132,266,edad 40
06266,Exaltación de la Cruz,46,118,113,231,edad 40
06266,Exaltación de la Cruz,47,137,117,254,edad 40
06266,Exaltación de la Cruz,48,122,128,250,edad 40
06266,Exaltación de la Cruz,49,124,143,267,edad 40
06266,Exaltación de la Cruz,50,147,128,275,edad 50
06266,Exaltación de la Cruz,51,125,98,223,edad 50
06266,Exaltación de la Cruz,52,131,131,262,edad 50
06266,Exaltación de la Cruz,53,112,111,223,edad 50
06266,Exaltación de la Cruz,54,112,101,213,edad 50
06266,Exaltación de la Cruz,55,131,117,248,edad 50
06266,Exaltación de la Cruz,56,121,104,225,edad 50
06266,Exaltación de la Cruz,57,107,112,219,edad 50
06266,Exaltación de la Cruz,58,100,82,182,edad 50
06266,Exaltación de la Cruz,59,100,92,192,edad 50
06266,Exaltación de la Cruz,60,105,104,209,edad 60
06266,Exaltación de la Cruz,61,94,93,187,edad 60
06266,Exaltación de la Cruz,62,98,82,180,edad 60
06266,Exaltación de la Cruz,63,92,92,184,edad 60
06266,Exaltación de la Cruz,64,79,67,146,edad 60
06266,Exaltación de la Cruz,65,93,90,183,edad 60
06266,Exaltación de la Cruz,66,58,73,131,edad 60
06266,Exaltación de la Cruz,67,63,67,130,edad 60
06266,Exaltación de la Cruz,68,54,58,112,edad 60
06266,Exaltación de la Cruz,69,68,65,133,edad 60
06266,Exaltación de la Cruz,70,57,61,118,edad 70
06266,Exaltación de la Cruz,71,57,73,130,edad 70
06266,Exaltación de la Cruz,72,49,74,123,edad 70
06266,Exaltación de la Cruz,73,49,51,100,edad 70
06266,Exaltación de la Cruz,74,40,61,101,edad 70
06266,Exaltación de la Cruz,75,43,57,100,edad 70
06266,Exaltación de la Cruz,76,40,51,91,edad 70
06266,Exaltación de la Cruz,77,37,34,71,edad 70
06266,Exaltación de la Cruz,78,39,50,89,edad 70
06266,Exaltación de la Cruz,79,25,51,76,edad 70
06266,Exaltación de la Cruz,80,27,40,67,edad 80
06266,Exaltación de la Cruz,81,22,34,56,edad 80
06266,Exaltación de la Cruz,82,23,25,48,edad 80
06266,Exaltación de la Cruz,83,11,22,33,edad 80
06266,Exaltación de la Cruz,84,5,18,23,edad 80
06266,Exaltación de la Cruz,85,7,24,31,edad 80
06266,Exaltación de la Cruz,86,6,27,33,edad 80
06266,Exaltación de la Cruz,87,5,23,28,edad 80
06266,Exaltación de la Cruz,88,5,21,26,edad 80
06266,Exaltación de la Cruz,89,1,13,14,edad 80
06266,Exaltación de la Cruz,90,2,7,9,edad 90
06266,Exaltación de la Cruz,91,1,6,7,edad 90
06266,Exaltación de la Cruz,92,5,5,10,edad 90
06266,Exaltación de la Cruz,93,2,4,6,edad 90
06266,Exaltación de la Cruz,94,2,0,2,edad 90
06266,Exaltación de la Cruz,95,1,3,4,edad 90
06266,Exaltación de la Cruz,96,0,2,2,edad 90
06266,Exaltación de la Cruz,97,2,1,3,edad 90
06266,Exaltación de la Cruz,98,0,2,2,edad 90
06277,Florentino Ameghino,0,73,51,124,edad 0
06277,Florentino Ameghino,1,76,60,136,edad 0
06277,Florentino Ameghino,2,81,82,163,edad 0
06277,Florentino Ameghino,3,74,57,131,edad 0
06277,Florentino Ameghino,4,77,70,147,edad 0
06277,Florentino Ameghino,5,100,84,184,edad 0
06277,Florentino Ameghino,6,70,81,151,edad 0
06277,Florentino Ameghino,7,90,95,185,edad 0
06277,Florentino Ameghino,8,82,78,160,edad 0
06277,Florentino Ameghino,9,88,79,167,edad 0
06277,Florentino Ameghino,10,95,86,181,edad 10
06277,Florentino Ameghino,11,86,84,170,edad 10
06277,Florentino Ameghino,12,75,81,156,edad 10
06277,Florentino Ameghino,13,80,78,158,edad 10
06277,Florentino Ameghino,14,78,78,156,edad 10
06277,Florentino Ameghino,15,62,48,110,edad 10
06277,Florentino Ameghino,16,78,58,136,edad 10
06277,Florentino Ameghino,17,62,62,124,edad 10
06277,Florentino Ameghino,18,76,73,149,edad 10
06277,Florentino Ameghino,19,64,53,117,edad 10
06277,Florentino Ameghino,20,52,60,112,edad 20
06277,Florentino Ameghino,21,51,64,115,edad 20
06277,Florentino Ameghino,22,46,54,100,edad 20
06277,Florentino Ameghino,23,61,39,100,edad 20
06277,Florentino Ameghino,24,43,61,104,edad 20
06277,Florentino Ameghino,25,52,43,95,edad 20
06277,Florentino Ameghino,26,36,60,96,edad 20
06277,Florentino Ameghino,27,61,53,114,edad 20
06277,Florentino Ameghino,28,48,53,101,edad 20
06277,Florentino Ameghino,29,41,55,96,edad 20
06277,Florentino Ameghino,30,51,60,111,edad 30
06277,Florentino Ameghino,31,44,63,107,edad 30
06277,Florentino Ameghino,32,46,54,100,edad 30
06277,Florentino Ameghino,33,61,36,97,edad 30
06277,Florentino Ameghino,34,49,53,102,edad 30
06277,Florentino Ameghino,35,46,46,92,edad 30
06277,Florentino Ameghino,36,44,61,105,edad 30
06277,Florentino Ameghino,37,58,55,113,edad 30
06277,Florentino Ameghino,38,58,51,109,edad 30
06277,Florentino Ameghino,39,60,53,113,edad 30
06277,Florentino Ameghino,40,59,56,115,edad 40
06277,Florentino Ameghino,41,57,56,113,edad 40
06277,Florentino Ameghino,42,50,56,106,edad 40
06277,Florentino Ameghino,43,43,45,88,edad 40
06277,Florentino Ameghino,44,45,44,89,edad 40
06277,Florentino Ameghino,45,48,45,93,edad 40
06277,Florentino Ameghino,46,60,35,95,edad 40
06277,Florentino Ameghino,47,36,34,70,edad 40
06277,Florentino Ameghino,48,51,54,105,edad 40
06277,Florentino Ameghino,49,44,48,92,edad 40
06277,Florentino Ameghino,50,57,40,97,edad 50
06277,Florentino Ameghino,51,54,59,113,edad 50
06277,Florentino Ameghino,52,49,35,84,edad 50
06277,Florentino Ameghino,53,43,57,100,edad 50
06277,Florentino Ameghino,54,47,35,82,edad 50
06277,Florentino Ameghino,55,40,32,72,edad 50
06277,Florentino Ameghino,56,42,38,80,edad 50
06277,Florentino Ameghino,57,35,32,67,edad 50
06277,Florentino Ameghino,58,38,26,64,edad 50
06277,Florentino Ameghino,59,34,30,64,edad 50
06277,Florentino Ameghino,60,41,36,77,edad 60
06277,Florentino Ameghino,61,36,43,79,edad 60
06277,Florentino Ameghino,62,29,26,55,edad 60
06277,Florentino Ameghino,63,23,25,48,edad 60
06277,Florentino Ameghino,64,24,39,63,edad 60
06277,Florentino Ameghino,65,47,22,69,edad 60
06277,Florentino Ameghino,66,30,26,56,edad 60
06277,Florentino Ameghino,67,31,35,66,edad 60
06277,Florentino Ameghino,68,29,24,53,edad 60
06277,Florentino Ameghino,69,24,26,50,edad 60
06277,Florentino Ameghino,70,23,28,51,edad 70
06277,Florentino Ameghino,71,27,36,63,edad 70
06277,Florentino Ameghino,72,28,29,57,edad 70
06277,Florentino Ameghino,73,19,28,47,edad 70
06277,Florentino Ameghino,74,29,30,59,edad 70
06277,Florentino Ameghino,75,28,29,57,edad 70
06277,Florentino Ameghino,76,21,27,48,edad 70
06277,Florentino Ameghino,77,14,18,32,edad 70
06277,Florentino Ameghino,78,20,20,40,edad 70
06277,Florentino Ameghino,79,12,23,35,edad 70
06277,Florentino Ameghino,80,9,16,25,edad 80
06277,Florentino Ameghino,81,8,17,25,edad 80
06277,Florentino Ameghino,82,8,14,22,edad 80
06277,Florentino Ameghino,83,6,15,21,edad 80
06277,Florentino Ameghino,84,9,5,14,edad 80
06277,Florentino Ameghino,85,8,8,16,edad 80
06277,Florentino Ameghino,86,8,9,17,edad 80
06277,Florentino Ameghino,87,4,5,9,edad 80
06277,Florentino Ameghino,88,3,9,12,edad 80
06277,Florentino Ameghino,89,1,8,9,edad 80
06277,Florentino Ameghino,90,3,1,4,edad 90
06277,Florentino Ameghino,91,3,3,6,edad 90
06277,Florentino Ameghino,92,1,3,4,edad 90
06277,Florentino Ameghino,93,1,1,2,edad 90
06277,Florentino Ameghino,94,0,1,1,edad 90
06277,Florentino Ameghino,95,0,1,1,edad 90
06277,Florentino Ameghino,96,0,1,1,edad 90
06277,Florentino Ameghino,99,0,1,1,edad 90
06280,General Alvarado,0,296,270,566,edad 0
06280,General Alvarado,1,272,246,518,edad 0
06280,General Alvarado,2,314,324,638,edad 0
06280,General Alvarado,3,310,293,603,edad 0
06280,General Alvarado,4,275,302,577,edad 0
06280,General Alvarado,5,301,295,596,edad 0
06280,General Alvarado,6,278,341,619,edad 0
06280,General Alvarado,7,310,292,602,edad 0
06280,General Alvarado,8,318,278,596,edad 0
06280,General Alvarado,9,368,299,667,edad 0
06280,General Alvarado,10,357,302,659,edad 10
06280,General Alvarado,11,329,303,632,edad 10
06280,General Alvarado,12,332,295,627,edad 10
06280,General Alvarado,13,314,323,637,edad 10
06280,General Alvarado,14,306,323,629,edad 10
06280,General Alvarado,15,311,337,648,edad 10
06280,General Alvarado,16,303,313,616,edad 10
06280,General Alvarado,17,307,249,556,edad 10
06280,General Alvarado,18,269,284,553,edad 10
06280,General Alvarado,19,287,281,568,edad 10
06280,General Alvarado,20,320,295,615,edad 20
06280,General Alvarado,21,271,277,548,edad 20
06280,General Alvarado,22,270,281,551,edad 20
06280,General Alvarado,23,262,264,526,edad 20
06280,General Alvarado,24,257,260,517,edad 20
06280,General Alvarado,25,258,219,477,edad 20
06280,General Alvarado,26,249,253,502,edad 20
06280,General Alvarado,27,210,207,417,edad 20
06280,General Alvarado,28,230,233,463,edad 20
06280,General Alvarado,29,196,204,400,edad 20
06280,General Alvarado,30,243,246,489,edad 30
06280,General Alvarado,31,183,215,398,edad 30
06280,General Alvarado,32,218,195,413,edad 30
06280,General Alvarado,33,205,220,425,edad 30
06280,General Alvarado,34,181,185,366,edad 30
06280,General Alvarado,35,199,214,413,edad 30
06280,General Alvarado,36,199,212,411,edad 30
06280,General Alvarado,37,199,224,423,edad 30
06280,General Alvarado,38,215,232,447,edad 30
06280,General Alvarado,39,162,193,355,edad 30
06280,General Alvarado,40,226,215,441,edad 40
06280,General Alvarado,41,189,212,401,edad 40
06280,General Alvarado,42,219,251,470,edad 40
06280,General Alvarado,43,207,183,390,edad 40
06280,General Alvarado,44,166,211,377,edad 40
06280,General Alvarado,45,203,208,411,edad 40
06280,General Alvarado,46,165,223,388,edad 40
06280,General Alvarado,47,198,189,387,edad 40
06280,General Alvarado,48,200,192,392,edad 40
06280,General Alvarado,49,184,176,360,edad 40
06280,General Alvarado,50,221,220,441,edad 50
06280,General Alvarado,51,208,195,403,edad 50
06280,General Alvarado,52,197,187,384,edad 50
06280,General Alvarado,53,168,197,365,edad 50
06280,General Alvarado,54,157,173,330,edad 50
06280,General Alvarado,55,168,167,335,edad 50
06280,General Alvarado,56,180,157,337,edad 50
06280,General Alvarado,57,148,145,293,edad 50
06280,General Alvarado,58,156,136,292,edad 50
06280,General Alvarado,59,149,137,286,edad 50
06280,General Alvarado,60,125,169,294,edad 60
06280,General Alvarado,61,120,121,241,edad 60
06280,General Alvarado,62,128,166,294,edad 60
06280,General Alvarado,63,123,131,254,edad 60
06280,General Alvarado,64,123,122,245,edad 60
06280,General Alvarado,65,147,164,311,edad 60
06280,General Alvarado,66,131,141,272,edad 60
06280,General Alvarado,67,126,132,258,edad 60
06280,General Alvarado,68,117,135,252,edad 60
06280,General Alvarado,69,122,129,251,edad 60
06280,General Alvarado,70,131,156,287,edad 70
06280,General Alvarado,71,118,151,269,edad 70
06280,General Alvarado,72,105,125,230,edad 70
06280,General Alvarado,73,92,108,200,edad 70
06280,General Alvarado,74,124,137,261,edad 70
06280,General Alvarado,75,79,137,216,edad 70
06280,General Alvarado,76,93,119,212,edad 70
06280,General Alvarado,77,78,97,175,edad 70
06280,General Alvarado,78,65,95,160,edad 70
06280,General Alvarado,79,68,70,138,edad 70
06280,General Alvarado,80,58,67,125,edad 80
06280,General Alvarado,81,39,67,106,edad 80
06280,General Alvarado,82,45,61,106,edad 80
06280,General Alvarado,83,34,60,94,edad 80
06280,General Alvarado,84,31,41,72,edad 80
06280,General Alvarado,85,18,42,60,edad 80
06280,General Alvarado,86,14,36,50,edad 80
06280,General Alvarado,87,16,35,51,edad 80
06280,General Alvarado,88,16,21,37,edad 80
06280,General Alvarado,89,2,17,19,edad 80
06280,General Alvarado,90,8,25,33,edad 90
06280,General Alvarado,91,3,20,23,edad 90
06280,General Alvarado,92,3,6,9,edad 90
06280,General Alvarado,93,3,6,9,edad 90
06280,General Alvarado,94,2,8,10,edad 90
06280,General Alvarado,95,1,6,7,edad 90
06280,General Alvarado,96,2,5,7,edad 90
06280,General Alvarado,97,1,3,4,edad 90
06280,General Alvarado,99,0,1,1,edad 90
06287,General Alvear,0,87,99,186,edad 0
06287,General Alvear,1,79,69,148,edad 0
06287,General Alvear,2,93,84,177,edad 0
06287,General Alvear,3,89,90,179,edad 0
06287,General Alvear,4,94,81,175,edad 0
06287,General Alvear,5,92,81,173,edad 0
06287,General Alvear,6,100,71,171,edad 0
06287,General Alvear,7,95,71,166,edad 0
06287,General Alvear,8,81,94,175,edad 0
06287,General Alvear,9,80,75,155,edad 0
06287,General Alvear,10,90,86,176,edad 10
06287,General Alvear,11,95,82,177,edad 10
06287,General Alvear,12,82,97,179,edad 10
06287,General Alvear,13,76,62,138,edad 10
06287,General Alvear,14,65,54,119,edad 10
06287,General Alvear,15,79,56,135,edad 10
06287,General Alvear,16,62,67,129,edad 10
06287,General Alvear,17,59,66,125,edad 10
06287,General Alvear,18,68,63,131,edad 10
06287,General Alvear,19,150,65,215,edad 10
06287,General Alvear,20,219,64,283,edad 20
06287,General Alvear,21,215,60,275,edad 20
06287,General Alvear,22,205,70,275,edad 20
06287,General Alvear,23,183,70,253,edad 20
06287,General Alvear,24,205,72,277,edad 20
06287,General Alvear,25,169,76,245,edad 20
06287,General Alvear,26,163,80,243,edad 20
06287,General Alvear,27,129,56,185,edad 20
06287,General Alvear,28,164,55,219,edad 20
06287,General Alvear,29,114,71,185,edad 20
06287,General Alvear,30,159,71,230,edad 30
06287,General Alvear,31,124,74,198,edad 30
06287,General Alvear,32,105,67,172,edad 30
06287,General Alvear,33,99,60,159,edad 30
06287,General Alvear,34,78,52,130,edad 30
06287,General Alvear,35,77,47,124,edad 30
06287,General Alvear,36,81,58,139,edad 30
06287,General Alvear,37,68,46,114,edad 30
06287,General Alvear,38,64,59,123,edad 30
06287,General Alvear,39,76,51,127,edad 30
06287,General Alvear,40,66,50,116,edad 40
06287,General Alvear,41,73,59,132,edad 40
06287,General Alvear,42,52,36,88,edad 40
06287,General Alvear,43,53,45,98,edad 40
06287,General Alvear,44,49,41,90,edad 40
06287,General Alvear,45,61,62,123,edad 40
06287,General Alvear,46,59,49,108,edad 40
06287,General Alvear,47,63,38,101,edad 40
06287,General Alvear,48,49,51,100,edad 40
06287,General Alvear,49,63,55,118,edad 40
06287,General Alvear,50,76,60,136,edad 50
06287,General Alvear,51,63,50,113,edad 50
06287,General Alvear,52,58,51,109,edad 50
06287,General Alvear,53,56,53,109,edad 50
06287,General Alvear,54,86,46,132,edad 50
06287,General Alvear,55,50,50,100,edad 50
06287,General Alvear,56,68,45,113,edad 50
06287,General Alvear,57,64,45,109,edad 50
06287,General Alvear,58,45,48,93,edad 50
06287,General Alvear,59,45,32,77,edad 50
06287,General Alvear,60,55,50,105,edad 60
06287,General Alvear,61,44,40,84,edad 60
06287,General Alvear,62,44,45,89,edad 60
06287,General Alvear,63,40,42,82,edad 60
06287,General Alvear,64,38,38,76,edad 60
06287,General Alvear,65,44,38,82,edad 60
06287,General Alvear,66,41,29,70,edad 60
06287,General Alvear,67,33,37,70,edad 60
06287,General Alvear,68,34,37,71,edad 60
06287,General Alvear,69,25,30,55,edad 60
06287,General Alvear,70,20,40,60,edad 70
06287,General Alvear,71,29,34,63,edad 70
06287,General Alvear,72,25,34,59,edad 70
06287,General Alvear,73,29,37,66,edad 70
06287,General Alvear,74,17,26,43,edad 70
06287,General Alvear,75,15,25,40,edad 70
06287,General Alvear,76,15,23,38,edad 70
06287,General Alvear,77,24,25,49,edad 70
06287,General Alvear,78,16,29,45,edad 70
06287,General Alvear,79,17,28,45,edad 70
06287,General Alvear,80,14,20,34,edad 80
06287,General Alvear,81,10,12,22,edad 80
06287,General Alvear,82,13,22,35,edad 80
06287,General Alvear,83,11,21,32,edad 80
06287,General Alvear,84,7,16,23,edad 80
06287,General Alvear,85,5,13,18,edad 80
06287,General Alvear,86,8,8,16,edad 80
06287,General Alvear,87,6,13,19,edad 80
06287,General Alvear,88,5,11,16,edad 80
06287,General Alvear,89,3,8,11,edad 80
06287,General Alvear,90,2,5,7,edad 90
06287,General Alvear,91,4,4,8,edad 90
06287,General Alvear,92,0,2,2,edad 90
06287,General Alvear,93,1,3,4,edad 90
06287,General Alvear,94,2,0,2,edad 90
06287,General Alvear,96,1,2,3,edad 90
06287,General Alvear,97,0,2,2,edad 90
06287,General Alvear,99,0,1,1,edad 90
06294,General Arenales,0,95,94,189,edad 0
06294,General Arenales,1,107,94,201,edad 0
06294,General Arenales,2,114,94,208,edad 0
06294,General Arenales,3,88,108,196,edad 0
06294,General Arenales,4,113,99,212,edad 0
06294,General Arenales,5,127,98,225,edad 0
06294,General Arenales,6,104,114,218,edad 0
06294,General Arenales,7,110,115,225,edad 0
06294,General Arenales,8,130,113,243,edad 0
06294,General Arenales,9,94,130,224,edad 0
06294,General Arenales,10,123,113,236,edad 10
06294,General Arenales,11,132,142,274,edad 10
06294,General Arenales,12,116,96,212,edad 10
06294,General Arenales,13,141,114,255,edad 10
06294,General Arenales,14,118,129,247,edad 10
06294,General Arenales,15,143,96,239,edad 10
06294,General Arenales,16,123,126,249,edad 10
06294,General Arenales,17,119,112,231,edad 10
06294,General Arenales,18,105,86,191,edad 10
06294,General Arenales,19,117,102,219,edad 10
06294,General Arenales,20,110,84,194,edad 20
06294,General Arenales,21,107,108,215,edad 20
06294,General Arenales,22,99,107,206,edad 20
06294,General Arenales,23,101,115,216,edad 20
06294,General Arenales,24,109,102,211,edad 20
06294,General Arenales,25,93,103,196,edad 20
06294,General Arenales,26,79,85,164,edad 20
06294,General Arenales,27,94,79,173,edad 20
06294,General Arenales,28,111,95,206,edad 20
06294,General Arenales,29,73,87,160,edad 20
06294,General Arenales,30,86,88,174,edad 30
06294,General Arenales,31,91,101,192,edad 30
06294,General Arenales,32,96,82,178,edad 30
06294,General Arenales,33,95,79,174,edad 30
06294,General Arenales,34,76,87,163,edad 30
06294,General Arenales,35,71,73,144,edad 30
06294,General Arenales,36,96,85,181,edad 30
06294,General Arenales,37,82,94,176,edad 30
06294,General Arenales,38,66,99,165,edad 30
06294,General Arenales,39,89,99,188,edad 30
06294,General Arenales,40,80,76,156,edad 40
06294,General Arenales,41,96,107,203,edad 40
06294,General Arenales,42,88,100,188,edad 40
06294,General Arenales,43,75,83,158,edad 40
06294,General Arenales,44,77,89,166,edad 40
06294,General Arenales,45,82,91,173,edad 40
06294,General Arenales,46,94,85,179,edad 40
06294,General Arenales,47,97,89,186,edad 40
06294,General Arenales,48,70,83,153,edad 40
06294,General Arenales,49,95,79,174,edad 40
06294,General Arenales,50,104,94,198,edad 50
06294,General Arenales,51,94,89,183,edad 50
06294,General Arenales,52,84,75,159,edad 50
06294,General Arenales,53,76,85,161,edad 50
06294,General Arenales,54,64,78,142,edad 50
06294,General Arenales,55,91,75,166,edad 50
06294,General Arenales,56,88,77,165,edad 50
06294,General Arenales,57,85,90,175,edad 50
06294,General Arenales,58,89,91,180,edad 50
06294,General Arenales,59,77,78,155,edad 50
06294,General Arenales,60,83,94,177,edad 60
06294,General Arenales,61,75,74,149,edad 60
06294,General Arenales,62,70,78,148,edad 60
06294,General Arenales,63,87,85,172,edad 60
06294,General Arenales,64,80,71,151,edad 60
06294,General Arenales,65,80,66,146,edad 60
06294,General Arenales,66,69,89,158,edad 60
06294,General Arenales,67,71,83,154,edad 60
06294,General Arenales,68,70,73,143,edad 60
06294,General Arenales,69,74,64,138,edad 60
06294,General Arenales,70,76,90,166,edad 70
06294,General Arenales,71,64,63,127,edad 70
06294,General Arenales,72,63,63,126,edad 70
06294,General Arenales,73,54,65,119,edad 70
06294,General Arenales,74,42,74,116,edad 70
06294,General Arenales,75,37,71,108,edad 70
06294,General Arenales,76,62,55,117,edad 70
06294,General Arenales,77,54,42,96,edad 70
06294,General Arenales,78,40,67,107,edad 70
06294,General Arenales,79,33,54,87,edad 70
06294,General Arenales,80,29,52,81,edad 80
06294,General Arenales,81,22,48,70,edad 80
06294,General Arenales,82,22,51,73,edad 80
06294,General Arenales,83,13,31,44,edad 80
06294,General Arenales,84,17,39,56,edad 80
06294,General Arenales,85,23,33,56,edad 80
06294,General Arenales,86,19,28,47,edad 80
06294,General Arenales,87,16,23,39,edad 80
06294,General Arenales,88,8,22,30,edad 80
06294,General Arenales,89,13,15,28,edad 80
06294,General Arenales,90,3,13,16,edad 90
06294,General Arenales,91,1,7,8,edad 90
06294,General Arenales,92,2,2,4,edad 90
06294,General Arenales,93,2,11,13,edad 90
06294,General Arenales,94,2,3,5,edad 90
06294,General Arenales,95,2,2,4,edad 90
06294,General Arenales,96,0,4,4,edad 90
06294,General Arenales,97,0,1,1,edad 90
06294,General Arenales,99,1,0,1,edad 90
06301,General Belgrano,0,130,108,238,edad 0
06301,General Belgrano,1,91,106,197,edad 0
06301,General Belgrano,2,135,88,223,edad 0
06301,General Belgrano,3,127,109,236,edad 0
06301,General Belgrano,4,121,132,253,edad 0
06301,General Belgrano,5,117,121,238,edad 0
06301,General Belgrano,6,114,133,247,edad 0
06301,General Belgrano,7,148,122,270,edad 0
06301,General Belgrano,8,118,119,237,edad 0
06301,General Belgrano,9,140,104,244,edad 0
06301,General Belgrano,10,130,102,232,edad 10
06301,General Belgrano,11,127,147,274,edad 10
06301,General Belgrano,12,109,144,253,edad 10
06301,General Belgrano,13,137,145,282,edad 10
06301,General Belgrano,14,121,115,236,edad 10
06301,General Belgrano,15,127,137,264,edad 10
06301,General Belgrano,16,117,147,264,edad 10
06301,General Belgrano,17,112,137,249,edad 10
06301,General Belgrano,18,116,123,239,edad 10
06301,General Belgrano,19,118,133,251,edad 10
06301,General Belgrano,20,109,117,226,edad 20
06301,General Belgrano,21,88,120,208,edad 20
06301,General Belgrano,22,107,120,227,edad 20
06301,General Belgrano,23,93,138,231,edad 20
06301,General Belgrano,24,124,116,240,edad 20
06301,General Belgrano,25,102,122,224,edad 20
06301,General Belgrano,26,122,89,211,edad 20
06301,General Belgrano,27,100,87,187,edad 20
06301,General Belgrano,28,116,102,218,edad 20
06301,General Belgrano,29,103,83,186,edad 20
06301,General Belgrano,30,90,110,200,edad 30
06301,General Belgrano,31,79,87,166,edad 30
06301,General Belgrano,32,89,67,156,edad 30
06301,General Belgrano,33,93,100,193,edad 30
06301,General Belgrano,34,80,57,137,edad 30
06301,General Belgrano,35,77,84,161,edad 30
06301,General Belgrano,36,70,90,160,edad 30
06301,General Belgrano,37,60,74,134,edad 30
06301,General Belgrano,38,67,96,163,edad 30
06301,General Belgrano,39,74,73,147,edad 30
06301,General Belgrano,40,90,97,187,edad 40
06301,General Belgrano,41,85,74,159,edad 40
06301,General Belgrano,42,77,108,185,edad 40
06301,General Belgrano,43,87,76,163,edad 40
06301,General Belgrano,44,79,77,156,edad 40
06301,General Belgrano,45,70,85,155,edad 40
06301,General Belgrano,46,65,90,155,edad 40
06301,General Belgrano,47,80,71,151,edad 40
06301,General Belgrano,48,90,85,175,edad 40
06301,General Belgrano,49,61,102,163,edad 40
06301,General Belgrano,50,101,107,208,edad 50
06301,General Belgrano,51,106,106,212,edad 50
06301,General Belgrano,52,92,89,181,edad 50
06301,General Belgrano,53,82,90,172,edad 50
06301,General Belgrano,54,105,111,216,edad 50
06301,General Belgrano,55,79,91,170,edad 50
06301,General Belgrano,56,94,122,216,edad 50
06301,General Belgrano,57,108,89,197,edad 50
06301,General Belgrano,58,92,98,190,edad 50
06301,General Belgrano,59,91,65,156,edad 50
06301,General Belgrano,60,71,108,179,edad 60
06301,General Belgrano,61,78,66,144,edad 60
06301,General Belgrano,62,81,82,163,edad 60
06301,General Belgrano,63,71,58,129,edad 60
06301,General Belgrano,64,50,80,130,edad 60
06301,General Belgrano,65,87,93,180,edad 60
06301,General Belgrano,66,64,60,124,edad 60
06301,General Belgrano,67,49,77,126,edad 60
06301,General Belgrano,68,53,76,129,edad 60
06301,General Belgrano,69,57,60,117,edad 60
06301,General Belgrano,70,58,64,122,edad 70
06301,General Belgrano,71,35,71,106,edad 70
06301,General Belgrano,72,52,51,103,edad 70
06301,General Belgrano,73,59,82,141,edad 70
06301,General Belgrano,74,57,63,120,edad 70
06301,General Belgrano,75,53,76,129,edad 70
06301,General Belgrano,76,40,70,110,edad 70
06301,General Belgrano,77,42,71,113,edad 70
06301,General Belgrano,78,33,55,88,edad 70
06301,General Belgrano,79,29,49,78,edad 70
06301,General Belgrano,80,32,53,85,edad 80
06301,General Belgrano,81,34,59,93,edad 80
06301,General Belgrano,82,23,57,80,edad 80
06301,General Belgrano,83,21,23,44,edad 80
06301,General Belgrano,84,16,30,46,edad 80
06301,General Belgrano,85,23,32,55,edad 80
06301,General Belgrano,86,16,17,33,edad 80
06301,General Belgrano,87,8,30,38,edad 80
06301,General Belgrano,88,4,19,23,edad 80
06301,General Belgrano,89,8,16,24,edad 80
06301,General Belgrano,90,4,14,18,edad 90
06301,General Belgrano,91,0,9,9,edad 90
06301,General Belgrano,92,3,5,8,edad 90
06301,General Belgrano,93,3,5,8,edad 90
06301,General Belgrano,94,1,0,1,edad 90
06301,General Belgrano,95,2,5,7,edad 90
06301,General Belgrano,96,0,4,4,edad 90
06301,General Belgrano,97,0,2,2,edad 90
06301,General Belgrano,98,0,3,3,edad 90
06308,General Guido,0,24,12,36,edad 0
06308,General Guido,1,18,24,42,edad 0
06308,General Guido,2,17,27,44,edad 0
06308,General Guido,3,23,21,44,edad 0
06308,General Guido,4,18,18,36,edad 0
06308,General Guido,5,30,24,54,edad 0
06308,General Guido,6,22,17,39,edad 0
06308,General Guido,7,24,26,50,edad 0
06308,General Guido,8,20,22,42,edad 0
06308,General Guido,9,39,21,60,edad 0
06308,General Guido,10,25,22,47,edad 10
06308,General Guido,11,22,27,49,edad 10
06308,General Guido,12,19,22,41,edad 10
06308,General Guido,13,23,18,41,edad 10
06308,General Guido,14,19,17,36,edad 10
06308,General Guido,15,21,23,44,edad 10
06308,General Guido,16,35,21,56,edad 10
06308,General Guido,17,16,21,37,edad 10
06308,General Guido,18,14,32,46,edad 10
06308,General Guido,19,21,22,43,edad 10
06308,General Guido,20,30,18,48,edad 20
06308,General Guido,21,19,20,39,edad 20
06308,General Guido,22,15,16,31,edad 20
06308,General Guido,23,19,19,38,edad 20
06308,General Guido,24,22,10,32,edad 20
06308,General Guido,25,24,16,40,edad 20
06308,General Guido,26,20,17,37,edad 20
06308,General Guido,27,21,11,32,edad 20
06308,General Guido,28,17,16,33,edad 20
06308,General Guido,29,15,15,30,edad 20
06308,General Guido,30,16,24,40,edad 30
06308,General Guido,31,13,14,27,edad 30
06308,General Guido,32,10,11,21,edad 30
06308,General Guido,33,14,14,28,edad 30
06308,General Guido,34,22,22,44,edad 30
06308,General Guido,35,14,14,28,edad 30
06308,General Guido,36,14,20,34,edad 30
06308,General Guido,37,19,8,27,edad 30
06308,General Guido,38,14,22,36,edad 30
06308,General Guido,39,13,16,29,edad 30
06308,General Guido,40,17,18,35,edad 40
06308,General Guido,41,12,17,29,edad 40
06308,General Guido,42,17,19,36,edad 40
06308,General Guido,43,21,7,28,edad 40
06308,General Guido,44,16,13,29,edad 40
06308,General Guido,45,13,11,24,edad 40
06308,General Guido,46,8,17,25,edad 40
06308,General Guido,47,27,17,44,edad 40
06308,General Guido,48,18,14,32,edad 40
06308,General Guido,49,17,8,25,edad 40
06308,General Guido,50,17,15,32,edad 50
06308,General Guido,51,23,20,43,edad 50
06308,General Guido,52,19,15,34,edad 50
06308,General Guido,53,18,14,32,edad 50
06308,General Guido,54,20,13,33,edad 50
06308,General Guido,55,22,15,37,edad 50
06308,General Guido,56,14,17,31,edad 50
06308,General Guido,57,21,15,36,edad 50
06308,General Guido,58,13,9,22,edad 50
06308,General Guido,59,14,14,28,edad 50
06308,General Guido,60,19,15,34,edad 60
06308,General Guido,61,13,17,30,edad 60
06308,General Guido,62,17,10,27,edad 60
06308,General Guido,63,16,19,35,edad 60
06308,General Guido,64,7,19,26,edad 60
06308,General Guido,65,13,13,26,edad 60
06308,General Guido,66,14,8,22,edad 60
06308,General Guido,67,12,16,28,edad 60
06308,General Guido,68,24,17,41,edad 60
06308,General Guido,69,11,8,19,edad 60
06308,General Guido,70,16,13,29,edad 70
06308,General Guido,71,17,12,29,edad 70
06308,General Guido,72,8,12,20,edad 70
06308,General Guido,73,13,6,19,edad 70
06308,General Guido,74,6,8,14,edad 70
06308,General Guido,75,10,15,25,edad 70
06308,General Guido,76,7,7,14,edad 70
06308,General Guido,77,11,5,16,edad 70
06308,General Guido,78,8,10,18,edad 70
06308,General Guido,79,6,8,14,edad 70
06308,General Guido,80,5,10,15,edad 80
06308,General Guido,81,4,3,7,edad 80
06308,General Guido,82,5,5,10,edad 80
06308,General Guido,83,4,2,6,edad 80
06308,General Guido,84,7,8,15,edad 80
06308,General Guido,85,0,4,4,edad 80
06308,General Guido,86,5,1,6,edad 80
06308,General Guido,87,0,4,4,edad 80
06308,General Guido,88,2,3,5,edad 80
06308,General Guido,89,1,1,2,edad 80
06308,General Guido,90,0,2,2,edad 90
06308,General Guido,92,2,2,4,edad 90
06308,General Guido,93,2,0,2,edad 90
06308,General Guido,94,0,3,3,edad 90
06308,General Guido,95,0,1,1,edad 90
06308,General Guido,96,0,1,1,edad 90
06308,General Guido,97,0,1,1,edad 90
06308,General Guido,99,0,1,1,edad 90
06315,General Juan Madariaga,0,150,180,330,edad 0
06315,General Juan Madariaga,1,172,166,338,edad 0
06315,General Juan Madariaga,2,184,146,330,edad 0
06315,General Juan Madariaga,3,174,190,364,edad 0
06315,General Juan Madariaga,4,166,167,333,edad 0
06315,General Juan Madariaga,5,168,173,341,edad 0
06315,General Juan Madariaga,6,180,150,330,edad 0
06315,General Juan Madariaga,7,192,166,358,edad 0
06315,General Juan Madariaga,8,183,178,361,edad 0
06315,General Juan Madariaga,9,169,170,339,edad 0
06315,General Juan Madariaga,10,191,177,368,edad 10
06315,General Juan Madariaga,11,190,190,380,edad 10
06315,General Juan Madariaga,12,180,175,355,edad 10
06315,General Juan Madariaga,13,188,168,356,edad 10
06315,General Juan Madariaga,14,197,145,342,edad 10
06315,General Juan Madariaga,15,168,164,332,edad 10
06315,General Juan Madariaga,16,152,151,303,edad 10
06315,General Juan Madariaga,17,172,202,374,edad 10
06315,General Juan Madariaga,18,142,155,297,edad 10
06315,General Juan Madariaga,19,115,146,261,edad 10
06315,General Juan Madariaga,20,125,161,286,edad 20
06315,General Juan Madariaga,21,132,148,280,edad 20
06315,General Juan Madariaga,22,128,146,274,edad 20
06315,General Juan Madariaga,23,138,150,288,edad 20
06315,General Juan Madariaga,24,120,106,226,edad 20
06315,General Juan Madariaga,25,90,119,209,edad 20
06315,General Juan Madariaga,26,116,126,242,edad 20
06315,General Juan Madariaga,27,102,127,229,edad 20
06315,General Juan Madariaga,28,113,116,229,edad 20
06315,General Juan Madariaga,29,125,113,238,edad 20
06315,General Juan Madariaga,30,132,119,251,edad 30
06315,General Juan Madariaga,31,117,115,232,edad 30
06315,General Juan Madariaga,32,112,113,225,edad 30
06315,General Juan Madariaga,33,96,90,186,edad 30
06315,General Juan Madariaga,34,85,121,206,edad 30
06315,General Juan Madariaga,35,89,129,218,edad 30
06315,General Juan Madariaga,36,105,132,237,edad 30
06315,General Juan Madariaga,37,102,111,213,edad 30
06315,General Juan Madariaga,38,114,116,230,edad 30
06315,General Juan Madariaga,39,110,107,217,edad 30
06315,General Juan Madariaga,40,106,124,230,edad 40
06315,General Juan Madariaga,41,99,104,203,edad 40
06315,General Juan Madariaga,42,107,115,222,edad 40
06315,General Juan Madariaga,43,111,100,211,edad 40
06315,General Juan Madariaga,44,99,104,203,edad 40
06315,General Juan Madariaga,45,98,107,205,edad 40
06315,General Juan Madariaga,46,105,96,201,edad 40
06315,General Juan Madariaga,47,88,95,183,edad 40
06315,General Juan Madariaga,48,99,119,218,edad 40
06315,General Juan Madariaga,49,85,95,180,edad 40
06315,General Juan Madariaga,50,97,106,203,edad 50
06315,General Juan Madariaga,51,107,98,205,edad 50
06315,General Juan Madariaga,52,94,105,199,edad 50
06315,General Juan Madariaga,53,120,109,229,edad 50
06315,General Juan Madariaga,54,89,91,180,edad 50
06315,General Juan Madariaga,55,94,89,183,edad 50
06315,General Juan Madariaga,56,83,83,166,edad 50
06315,General Juan Madariaga,57,81,87,168,edad 50
06315,General Juan Madariaga,58,69,98,167,edad 50
06315,General Juan Madariaga,59,75,83,158,edad 50
06315,General Juan Madariaga,60,87,70,157,edad 60
06315,General Juan Madariaga,61,66,68,134,edad 60
06315,General Juan Madariaga,62,67,86,153,edad 60
06315,General Juan Madariaga,63,45,68,113,edad 60
06315,General Juan Madariaga,64,71,69,140,edad 60
06315,General Juan Madariaga,65,64,81,145,edad 60
06315,General Juan Madariaga,66,70,72,142,edad 60
06315,General Juan Madariaga,67,50,75,125,edad 60
06315,General Juan Madariaga,68,56,73,129,edad 60
06315,General Juan Madariaga,69,58,62,120,edad 60
06315,General Juan Madariaga,70,62,76,138,edad 70
06315,General Juan Madariaga,71,52,62,114,edad 70
06315,General Juan Madariaga,72,51,66,117,edad 70
06315,General Juan Madariaga,73,43,77,120,edad 70
06315,General Juan Madariaga,74,42,71,113,edad 70
06315,General Juan Madariaga,75,47,59,106,edad 70
06315,General Juan Madariaga,76,47,46,93,edad 70
06315,General Juan Madariaga,77,37,50,87,edad 70
06315,General Juan Madariaga,78,26,48,74,edad 70
06315,General Juan Madariaga,79,40,42,82,edad 70
06315,General Juan Madariaga,80,21,30,51,edad 80
06315,General Juan Madariaga,81,29,30,59,edad 80
06315,General Juan Madariaga,82,16,40,56,edad 80
06315,General Juan Madariaga,83,16,27,43,edad 80
06315,General Juan Madariaga,84,13,23,36,edad 80
06315,General Juan Madariaga,85,17,21,38,edad 80
06315,General Juan Madariaga,86,10,16,26,edad 80
06315,General Juan Madariaga,87,13,22,35,edad 80
06315,General Juan Madariaga,88,8,13,21,edad 80
06315,General Juan Madariaga,89,7,17,24,edad 80
06315,General Juan Madariaga,90,5,11,16,edad 90
06315,General Juan Madariaga,91,8,10,18,edad 90
06315,General Juan Madariaga,92,4,2,6,edad 90
06315,General Juan Madariaga,93,2,9,11,edad 90
06315,General Juan Madariaga,94,3,3,6,edad 90
06315,General Juan Madariaga,95,0,4,4,edad 90
06315,General Juan Madariaga,96,1,3,4,edad 90
06315,General Juan Madariaga,97,0,2,2,edad 90
06315,General Juan Madariaga,98,1,0,1,edad 90
06315,General Juan Madariaga,99,3,0,3,edad 90
06322,General La Madrid,0,79,84,163,edad 0
06322,General La Madrid,1,109,91,200,edad 0
06322,General La Madrid,2,92,91,183,edad 0
06322,General La Madrid,3,89,92,181,edad 0
06322,General La Madrid,4,102,102,204,edad 0
06322,General La Madrid,5,93,96,189,edad 0
06322,General La Madrid,6,92,95,187,edad 0
06322,General La Madrid,7,122,111,233,edad 0
06322,General La Madrid,8,95,109,204,edad 0
06322,General La Madrid,9,102,104,206,edad 0
06322,General La Madrid,10,115,109,224,edad 10
06322,General La Madrid,11,118,94,212,edad 10
06322,General La Madrid,12,96,84,180,edad 10
06322,General La Madrid,13,106,101,207,edad 10
06322,General La Madrid,14,100,102,202,edad 10
06322,General La Madrid,15,116,88,204,edad 10
06322,General La Madrid,16,104,83,187,edad 10
06322,General La Madrid,17,99,89,188,edad 10
06322,General La Madrid,18,82,86,168,edad 10
06322,General La Madrid,19,72,75,147,edad 10
06322,General La Madrid,20,83,75,158,edad 20
06322,General La Madrid,21,69,70,139,edad 20
06322,General La Madrid,22,80,85,165,edad 20
06322,General La Madrid,23,83,68,151,edad 20
06322,General La Madrid,24,65,73,138,edad 20
06322,General La Madrid,25,69,53,122,edad 20
06322,General La Madrid,26,75,88,163,edad 20
06322,General La Madrid,27,76,78,154,edad 20
06322,General La Madrid,28,65,79,144,edad 20
06322,General La Madrid,29,78,82,160,edad 20
06322,General La Madrid,30,68,89,157,edad 30
06322,General La Madrid,31,74,82,156,edad 30
06322,General La Madrid,32,79,66,145,edad 30
06322,General La Madrid,33,72,66,138,edad 30
06322,General La Madrid,34,67,76,143,edad 30
06322,General La Madrid,35,49,64,113,edad 30
06322,General La Madrid,36,65,55,120,edad 30
06322,General La Madrid,37,73,68,141,edad 30
06322,General La Madrid,38,73,61,134,edad 30
06322,General La Madrid,39,76,78,154,edad 30
06322,General La Madrid,40,61,67,128,edad 40
06322,General La Madrid,41,78,55,133,edad 40
06322,General La Madrid,42,75,67,142,edad 40
06322,General La Madrid,43,74,75,149,edad 40
06322,General La Madrid,44,53,68,121,edad 40
06322,General La Madrid,45,64,63,127,edad 40
06322,General La Madrid,46,71,48,119,edad 40
06322,General La Madrid,47,68,73,141,edad 40
06322,General La Madrid,48,70,64,134,edad 40
06322,General La Madrid,49,73,63,136,edad 40
06322,General La Madrid,50,60,63,123,edad 50
06322,General La Madrid,51,46,56,102,edad 50
06322,General La Madrid,52,67,79,146,edad 50
06322,General La Madrid,53,54,61,115,edad 50
06322,General La Madrid,54,74,56,130,edad 50
06322,General La Madrid,55,88,54,142,edad 50
06322,General La Madrid,56,73,52,125,edad 50
06322,General La Madrid,57,53,55,108,edad 50
06322,General La Madrid,58,53,51,104,edad 50
06322,General La Madrid,59,50,54,104,edad 50
06322,General La Madrid,60,51,54,105,edad 60
06322,General La Madrid,61,45,40,85,edad 60
06322,General La Madrid,62,62,41,103,edad 60
06322,General La Madrid,63,27,35,62,edad 60
06322,General La Madrid,64,40,41,81,edad 60
06322,General La Madrid,65,50,36,86,edad 60
06322,General La Madrid,66,31,41,72,edad 60
06322,General La Madrid,67,38,38,76,edad 60
06322,General La Madrid,68,35,31,66,edad 60
06322,General La Madrid,69,25,16,41,edad 60
06322,General La Madrid,70,33,41,74,edad 70
06322,General La Madrid,71,37,33,70,edad 70
06322,General La Madrid,72,26,35,61,edad 70
06322,General La Madrid,73,42,30,72,edad 70
06322,General La Madrid,74,26,38,64,edad 70
06322,General La Madrid,75,27,33,60,edad 70
06322,General La Madrid,76,21,24,45,edad 70
06322,General La Madrid,77,23,27,50,edad 70
06322,General La Madrid,78,20,32,52,edad 70
06322,General La Madrid,79,12,30,42,edad 70
06322,General La Madrid,80,10,22,32,edad 80
06322,General La Madrid,81,9,23,32,edad 80
06322,General La Madrid,82,8,27,35,edad 80
06322,General La Madrid,83,11,20,31,edad 80
06322,General La Madrid,84,11,22,33,edad 80
06322,General La Madrid,85,8,16,24,edad 80
06322,General La Madrid,86,6,20,26,edad 80
06322,General La Madrid,87,11,16,27,edad 80
06322,General La Madrid,88,6,11,17,edad 80
06322,General La Madrid,89,8,12,20,edad 80
06322,General La Madrid,90,1,10,11,edad 90
06322,General La Madrid,91,1,2,3,edad 90
06322,General La Madrid,92,3,7,10,edad 90
06322,General La Madrid,93,3,7,10,edad 90
06322,General La Madrid,94,1,6,7,edad 90
06322,General La Madrid,95,1,0,1,edad 90
06322,General La Madrid,96,0,4,4,edad 90
06322,General La Madrid,97,0,1,1,edad 90
06329,General Las Heras,0,129,121,250,edad 0
06329,General Las Heras,1,115,101,216,edad 0
06329,General Las Heras,2,96,111,207,edad 0
06329,General Las Heras,3,109,130,239,edad 0
06329,General Las Heras,4,110,113,223,edad 0
06329,General Las Heras,5,134,143,277,edad 0
06329,General Las Heras,6,132,121,253,edad 0
06329,General Las Heras,7,111,104,215,edad 0
06329,General Las Heras,8,122,116,238,edad 0
06329,General Las Heras,9,121,111,232,edad 0
06329,General Las Heras,10,128,115,243,edad 10
06329,General Las Heras,11,130,113,243,edad 10
06329,General Las Heras,12,118,130,248,edad 10
06329,General Las Heras,13,111,107,218,edad 10
06329,General Las Heras,14,139,111,250,edad 10
06329,General Las Heras,15,124,140,264,edad 10
06329,General Las Heras,16,115,111,226,edad 10
06329,General Las Heras,17,130,110,240,edad 10
06329,General Las Heras,18,119,104,223,edad 10
06329,General Las Heras,19,107,114,221,edad 10
06329,General Las Heras,20,115,98,213,edad 20
06329,General Las Heras,21,110,89,199,edad 20
06329,General Las Heras,22,85,115,200,edad 20
06329,General Las Heras,23,106,89,195,edad 20
06329,General Las Heras,24,89,113,202,edad 20
06329,General Las Heras,25,99,84,183,edad 20
06329,General Las Heras,26,80,85,165,edad 20
06329,General Las Heras,27,93,91,184,edad 20
06329,General Las Heras,28,94,111,205,edad 20
06329,General Las Heras,29,81,94,175,edad 20
06329,General Las Heras,30,92,92,184,edad 30
06329,General Las Heras,31,78,83,161,edad 30
06329,General Las Heras,32,81,91,172,edad 30
06329,General Las Heras,33,93,65,158,edad 30
06329,General Las Heras,34,68,77,145,edad 30
06329,General Las Heras,35,88,85,173,edad 30
06329,General Las Heras,36,91,82,173,edad 30
06329,General Las Heras,37,74,71,145,edad 30
06329,General Las Heras,38,72,81,153,edad 30
06329,General Las Heras,39,71,79,150,edad 30
06329,General Las Heras,40,88,94,182,edad 40
06329,General Las Heras,41,71,74,145,edad 40
06329,General Las Heras,42,89,97,186,edad 40
06329,General Las Heras,43,84,74,158,edad 40
06329,General Las Heras,44,82,64,146,edad 40
06329,General Las Heras,45,72,72,144,edad 40
06329,General Las Heras,46,74,83,157,edad 40
06329,General Las Heras,47,62,67,129,edad 40
06329,General Las Heras,48,59,70,129,edad 40
06329,General Las Heras,49,63,60,123,edad 40
06329,General Las Heras,50,64,79,143,edad 50
06329,General Las Heras,51,66,62,128,edad 50
06329,General Las Heras,52,67,66,133,edad 50
06329,General Las Heras,53,64,59,123,edad 50
06329,General Las Heras,54,57,73,130,edad 50
06329,General Las Heras,55,72,57,129,edad 50
06329,General Las Heras,56,59,55,114,edad 50
06329,General Las Heras,57,53,48,101,edad 50
06329,General Las Heras,58,43,53,96,edad 50
06329,General Las Heras,59,47,47,94,edad 50
06329,General Las Heras,60,44,62,106,edad 60
06329,General Las Heras,61,48,54,102,edad 60
06329,General Las Heras,62,55,50,105,edad 60
06329,General Las Heras,63,50,58,108,edad 60
06329,General Las Heras,64,37,43,80,edad 60
06329,General Las Heras,65,51,42,93,edad 60
06329,General Las Heras,66,32,47,79,edad 60
06329,General Las Heras,67,33,31,64,edad 60
06329,General Las Heras,68,40,53,93,edad 60
06329,General Las Heras,69,42,35,77,edad 60
06329,General Las Heras,70,40,53,93,edad 70
06329,General Las Heras,71,36,34,70,edad 70
06329,General Las Heras,72,34,55,89,edad 70
06329,General Las Heras,73,32,51,83,edad 70
06329,General Las Heras,74,25,39,64,edad 70
06329,General Las Heras,75,28,32,60,edad 70
06329,General Las Heras,76,27,34,61,edad 70
06329,General Las Heras,77,26,24,50,edad 70
06329,General Las Heras,78,15,37,52,edad 70
06329,General Las Heras,79,12,26,38,edad 70
06329,General Las Heras,80,18,24,42,edad 80
06329,General Las Heras,81,11,20,31,edad 80
06329,General Las Heras,82,17,20,37,edad 80
06329,General Las Heras,83,15,10,25,edad 80
06329,General Las Heras,84,12,15,27,edad 80
06329,General Las Heras,85,9,19,28,edad 80
06329,General Las Heras,86,9,12,21,edad 80
06329,General Las Heras,87,4,7,11,edad 80
06329,General Las Heras,88,2,11,13,edad 80
06329,General Las Heras,89,3,6,9,edad 80
06329,General Las Heras,90,1,8,9,edad 90
06329,General Las Heras,91,3,4,7,edad 90
06329,General Las Heras,92,2,2,4,edad 90
06329,General Las Heras,93,0,6,6,edad 90
06329,General Las Heras,94,1,3,4,edad 90
06329,General Las Heras,95,2,3,5,edad 90
06329,General Las Heras,99,1,0,1,edad 90
06336,General Lavalle,0,39,27,66,edad 0
06336,General Lavalle,1,31,18,49,edad 0
06336,General Lavalle,2,28,35,63,edad 0
06336,General Lavalle,3,28,30,58,edad 0
06336,General Lavalle,4,34,35,69,edad 0
06336,General Lavalle,5,28,32,60,edad 0
06336,General Lavalle,6,35,38,73,edad 0
06336,General Lavalle,7,39,33,72,edad 0
06336,General Lavalle,8,41,34,75,edad 0
06336,General Lavalle,9,27,31,58,edad 0
06336,General Lavalle,10,38,29,67,edad 10
06336,General Lavalle,11,38,34,72,edad 10
06336,General Lavalle,12,26,25,51,edad 10
06336,General Lavalle,13,24,21,45,edad 10
06336,General Lavalle,14,36,30,66,edad 10
06336,General Lavalle,15,27,27,54,edad 10
06336,General Lavalle,16,26,26,52,edad 10
06336,General Lavalle,17,24,15,39,edad 10
06336,General Lavalle,18,26,17,43,edad 10
06336,General Lavalle,19,23,16,39,edad 10
06336,General Lavalle,20,24,22,46,edad 20
06336,General Lavalle,21,26,26,52,edad 20
06336,General Lavalle,22,19,25,44,edad 20
06336,General Lavalle,23,26,35,61,edad 20
06336,General Lavalle,24,21,15,36,edad 20
06336,General Lavalle,25,23,27,50,edad 20
06336,General Lavalle,26,22,24,46,edad 20
06336,General Lavalle,27,22,17,39,edad 20
06336,General Lavalle,28,25,15,40,edad 20
06336,General Lavalle,29,23,14,37,edad 20
06336,General Lavalle,30,23,18,41,edad 30
06336,General Lavalle,31,25,20,45,edad 30
06336,General Lavalle,32,18,25,43,edad 30
06336,General Lavalle,33,21,17,38,edad 30
06336,General Lavalle,34,12,22,34,edad 30
06336,General Lavalle,35,20,22,42,edad 30
06336,General Lavalle,36,14,25,39,edad 30
06336,General Lavalle,37,14,14,28,edad 30
06336,General Lavalle,38,14,21,35,edad 30
06336,General Lavalle,39,23,25,48,edad 30
06336,General Lavalle,40,25,12,37,edad 40
06336,General Lavalle,41,18,11,29,edad 40
06336,General Lavalle,42,15,12,27,edad 40
06336,General Lavalle,43,15,15,30,edad 40
06336,General Lavalle,44,10,14,24,edad 40
06336,General Lavalle,45,19,20,39,edad 40
06336,General Lavalle,46,20,23,43,edad 40
06336,General Lavalle,47,20,11,31,edad 40
06336,General Lavalle,48,16,9,25,edad 40
06336,General Lavalle,49,15,8,23,edad 40
06336,General Lavalle,50,24,21,45,edad 50
06336,General Lavalle,51,22,15,37,edad 50
06336,General Lavalle,52,21,16,37,edad 50
06336,General Lavalle,53,22,12,34,edad 50
06336,General Lavalle,54,19,13,32,edad 50
06336,General Lavalle,55,19,12,31,edad 50
06336,General Lavalle,56,11,20,31,edad 50
06336,General Lavalle,57,19,11,30,edad 50
06336,General Lavalle,58,15,9,24,edad 50
06336,General Lavalle,59,16,13,29,edad 50
06336,General Lavalle,60,17,14,31,edad 60
06336,General Lavalle,61,17,11,28,edad 60
06336,General Lavalle,62,13,14,27,edad 60
06336,General Lavalle,63,15,15,30,edad 60
06336,General Lavalle,64,13,14,27,edad 60
06336,General Lavalle,65,12,11,23,edad 60
06336,General Lavalle,66,16,4,20,edad 60
06336,General Lavalle,67,13,7,20,edad 60
06336,General Lavalle,68,7,10,17,edad 60
06336,General Lavalle,69,11,9,20,edad 60
06336,General Lavalle,70,10,8,18,edad 70
06336,General Lavalle,71,9,5,14,edad 70
06336,General Lavalle,72,11,4,15,edad 70
06336,General Lavalle,73,7,7,14,edad 70
06336,General Lavalle,74,4,5,9,edad 70
06336,General Lavalle,75,3,6,9,edad 70
06336,General Lavalle,76,6,4,10,edad 70
06336,General Lavalle,77,5,6,11,edad 70
06336,General Lavalle,78,5,4,9,edad 70
06336,General Lavalle,79,6,6,12,edad 70
06336,General Lavalle,80,6,4,10,edad 80
06336,General Lavalle,81,3,6,9,edad 80
06336,General Lavalle,82,3,2,5,edad 80
06336,General Lavalle,83,1,1,2,edad 80
06336,General Lavalle,84,2,1,3,edad 80
06336,General Lavalle,85,2,3,5,edad 80
06336,General Lavalle,86,1,3,4,edad 80
06336,General Lavalle,87,1,0,1,edad 80
06336,General Lavalle,88,0,2,2,edad 80
06336,General Lavalle,89,0,1,1,edad 80
06336,General Lavalle,90,0,1,1,edad 90
06336,General Lavalle,92,1,1,2,edad 90
06336,General Lavalle,97,0,1,1,edad 90
06343,General Paz,0,96,82,178,edad 0
06343,General Paz,1,74,83,157,edad 0
06343,General Paz,2,103,80,183,edad 0
06343,General Paz,3,84,84,168,edad 0
06343,General Paz,4,78,87,165,edad 0
06343,General Paz,5,79,92,171,edad 0
06343,General Paz,6,85,78,163,edad 0
06343,General Paz,7,93,79,172,edad 0
06343,General Paz,8,86,83,169,edad 0
06343,General Paz,9,104,88,192,edad 0
06343,General Paz,10,113,84,197,edad 10
06343,General Paz,11,95,85,180,edad 10
06343,General Paz,12,91,93,184,edad 10
06343,General Paz,13,85,91,176,edad 10
06343,General Paz,14,102,91,193,edad 10
06343,General Paz,15,99,93,192,edad 10
06343,General Paz,16,102,84,186,edad 10
06343,General Paz,17,87,73,160,edad 10
06343,General Paz,18,91,87,178,edad 10
06343,General Paz,19,71,81,152,edad 10
06343,General Paz,20,85,75,160,edad 20
06343,General Paz,21,86,97,183,edad 20
06343,General Paz,22,110,77,187,edad 20
06343,General Paz,23,63,96,159,edad 20
06343,General Paz,24,67,77,144,edad 20
06343,General Paz,25,79,58,137,edad 20
06343,General Paz,26,69,71,140,edad 20
06343,General Paz,27,74,69,143,edad 20
06343,General Paz,28,66,76,142,edad 20
06343,General Paz,29,90,68,158,edad 20
06343,General Paz,30,65,65,130,edad 30
06343,General Paz,31,67,63,130,edad 30
06343,General Paz,32,46,54,100,edad 30
06343,General Paz,33,54,60,114,edad 30
06343,General Paz,34,50,47,97,edad 30
06343,General Paz,35,44,39,83,edad 30
06343,General Paz,36,49,49,98,edad 30
06343,General Paz,37,43,49,92,edad 30
06343,General Paz,38,70,63,133,edad 30
06343,General Paz,39,54,54,108,edad 30
06343,General Paz,40,62,74,136,edad 40
06343,General Paz,41,38,63,101,edad 40
06343,General Paz,42,79,57,136,edad 40
06343,General Paz,43,56,59,115,edad 40
06343,General Paz,44,51,63,114,edad 40
06343,General Paz,45,67,58,125,edad 40
06343,General Paz,46,54,66,120,edad 40
06343,General Paz,47,69,49,118,edad 40
06343,General Paz,48,50,49,99,edad 40
06343,General Paz,49,70,60,130,edad 40
06343,General Paz,50,67,71,138,edad 50
06343,General Paz,51,57,53,110,edad 50
06343,General Paz,52,55,51,106,edad 50
06343,General Paz,53,69,67,136,edad 50
06343,General Paz,54,54,46,100,edad 50
06343,General Paz,55,59,51,110,edad 50
06343,General Paz,56,56,63,119,edad 50
06343,General Paz,57,38,46,84,edad 50
06343,General Paz,58,60,56,116,edad 50
06343,General Paz,59,40,40,80,edad 50
06343,General Paz,60,63,60,123,edad 60
06343,General Paz,61,43,40,83,edad 60
06343,General Paz,62,42,40,82,edad 60
06343,General Paz,63,25,42,67,edad 60
06343,General Paz,64,41,43,84,edad 60
06343,General Paz,65,32,37,69,edad 60
06343,General Paz,66,61,52,113,edad 60
06343,General Paz,67,31,42,73,edad 60
06343,General Paz,68,30,47,77,edad 60
06343,General Paz,69,31,35,66,edad 60
06343,General Paz,70,46,39,85,edad 70
06343,General Paz,71,29,41,70,edad 70
06343,General Paz,72,40,44,84,edad 70
06343,General Paz,73,35,41,76,edad 70
06343,General Paz,74,35,38,73,edad 70
06343,General Paz,75,34,39,73,edad 70
06343,General Paz,76,31,46,77,edad 70
06343,General Paz,77,27,43,70,edad 70
06343,General Paz,78,20,29,49,edad 70
06343,General Paz,79,23,23,46,edad 70
06343,General Paz,80,14,28,42,edad 80
06343,General Paz,81,14,24,38,edad 80
06343,General Paz,82,9,27,36,edad 80
06343,General Paz,83,18,22,40,edad 80
06343,General Paz,84,8,16,24,edad 80
06343,General Paz,85,8,20,28,edad 80
06343,General Paz,86,6,21,27,edad 80
06343,General Paz,87,5,15,20,edad 80
06343,General Paz,88,4,11,15,edad 80
06343,General Paz,89,5,12,17,edad 80
06343,General Paz,90,1,15,16,edad 90
06343,General Paz,91,4,8,12,edad 90
06343,General Paz,92,3,2,5,edad 90
06343,General Paz,93,1,1,2,edad 90
06343,General Paz,94,1,3,4,edad 90
06343,General Paz,95,0,2,2,edad 90
06343,General Paz,96,1,0,1,edad 90
06343,General Paz,97,1,1,2,edad 90
06351,General Pinto,0,115,94,209,edad 0
06351,General Pinto,1,84,78,162,edad 0
06351,General Pinto,2,118,92,210,edad 0
06351,General Pinto,3,98,96,194,edad 0
06351,General Pinto,4,99,76,175,edad 0
06351,General Pinto,5,102,101,203,edad 0
06351,General Pinto,6,115,97,212,edad 0
06351,General Pinto,7,95,91,186,edad 0
06351,General Pinto,8,128,84,212,edad 0
06351,General Pinto,9,112,101,213,edad 0
06351,General Pinto,10,125,97,222,edad 10
06351,General Pinto,11,102,101,203,edad 10
06351,General Pinto,12,100,102,202,edad 10
06351,General Pinto,13,110,92,202,edad 10
06351,General Pinto,14,109,104,213,edad 10
06351,General Pinto,15,101,103,204,edad 10
06351,General Pinto,16,94,95,189,edad 10
06351,General Pinto,17,93,81,174,edad 10
06351,General Pinto,18,92,67,159,edad 10
06351,General Pinto,19,81,73,154,edad 10
06351,General Pinto,20,73,70,143,edad 20
06351,General Pinto,21,72,83,155,edad 20
06351,General Pinto,22,85,78,163,edad 20
06351,General Pinto,23,70,78,148,edad 20
06351,General Pinto,24,79,72,151,edad 20
06351,General Pinto,25,74,89,163,edad 20
06351,General Pinto,26,72,81,153,edad 20
06351,General Pinto,27,81,80,161,edad 20
06351,General Pinto,28,76,70,146,edad 20
06351,General Pinto,29,73,79,152,edad 20
06351,General Pinto,30,72,78,150,edad 30
06351,General Pinto,31,61,70,131,edad 30
06351,General Pinto,32,67,77,144,edad 30
06351,General Pinto,33,65,54,119,edad 30
06351,General Pinto,34,60,69,129,edad 30
06351,General Pinto,35,49,66,115,edad 30
06351,General Pinto,36,65,60,125,edad 30
06351,General Pinto,37,67,70,137,edad 30
06351,General Pinto,38,70,74,144,edad 30
06351,General Pinto,39,66,62,128,edad 30
06351,General Pinto,40,63,54,117,edad 40
06351,General Pinto,41,67,64,131,edad 40
06351,General Pinto,42,77,58,135,edad 40
06351,General Pinto,43,65,61,126,edad 40
06351,General Pinto,44,69,62,131,edad 40
06351,General Pinto,45,79,62,141,edad 40
06351,General Pinto,46,54,64,118,edad 40
06351,General Pinto,47,54,53,107,edad 40
06351,General Pinto,48,64,63,127,edad 40
06351,General Pinto,49,63,67,130,edad 40
06351,General Pinto,50,63,79,142,edad 50
06351,General Pinto,51,73,84,157,edad 50
06351,General Pinto,52,67,63,130,edad 50
06351,General Pinto,53,75,67,142,edad 50
06351,General Pinto,54,61,70,131,edad 50
06351,General Pinto,55,60,61,121,edad 50
06351,General Pinto,56,74,56,130,edad 50
06351,General Pinto,57,66,46,112,edad 50
06351,General Pinto,58,64,55,119,edad 50
06351,General Pinto,59,66,49,115,edad 50
06351,General Pinto,60,61,46,107,edad 60
06351,General Pinto,61,41,45,86,edad 60
06351,General Pinto,62,49,55,104,edad 60
06351,General Pinto,63,46,49,95,edad 60
06351,General Pinto,64,44,40,84,edad 60
06351,General Pinto,65,48,45,93,edad 60
06351,General Pinto,66,35,46,81,edad 60
06351,General Pinto,67,43,39,82,edad 60
06351,General Pinto,68,30,31,61,edad 60
06351,General Pinto,69,37,55,92,edad 60
06351,General Pinto,70,46,39,85,edad 70
06351,General Pinto,71,28,34,62,edad 70
06351,General Pinto,72,28,30,58,edad 70
06351,General Pinto,73,32,39,71,edad 70
06351,General Pinto,74,31,38,69,edad 70
06351,General Pinto,75,28,36,64,edad 70
06351,General Pinto,76,30,23,53,edad 70
06351,General Pinto,77,24,29,53,edad 70
06351,General Pinto,78,27,19,46,edad 70
06351,General Pinto,79,21,24,45,edad 70
06351,General Pinto,80,22,42,64,edad 80
06351,General Pinto,81,14,28,42,edad 80
06351,General Pinto,82,18,22,40,edad 80
06351,General Pinto,83,3,14,17,edad 80
06351,General Pinto,84,10,17,27,edad 80
06351,General Pinto,85,10,12,22,edad 80
06351,General Pinto,86,4,16,20,edad 80
06351,General Pinto,87,7,12,19,edad 80
06351,General Pinto,88,7,10,17,edad 80
06351,General Pinto,89,6,9,15,edad 80
06351,General Pinto,90,2,8,10,edad 90
06351,General Pinto,91,3,5,8,edad 90
06351,General Pinto,92,2,5,7,edad 90
06351,General Pinto,93,2,5,7,edad 90
06351,General Pinto,94,2,0,2,edad 90
06351,General Pinto,95,0,1,1,edad 90
06351,General Pinto,96,1,0,1,edad 90
06351,General Pinto,99,0,1,1,edad 90
06357,General Pueyrredón,0,4334,4211,8545,edad 0
06357,General Pueyrredón,1,3990,3627,7617,edad 0
06357,General Pueyrredón,2,4388,4313,8701,edad 0
06357,General Pueyrredón,3,4193,4110,8303,edad 0
06357,General Pueyrredón,4,4225,4125,8350,edad 0
06357,General Pueyrredón,5,4552,4359,8911,edad 0
06357,General Pueyrredón,6,4445,4313,8758,edad 0
06357,General Pueyrredón,7,4334,4185,8519,edad 0
06357,General Pueyrredón,8,4553,4359,8912,edad 0
06357,General Pueyrredón,9,4722,4467,9189,edad 0
06357,General Pueyrredón,10,4884,4664,9548,edad 10
06357,General Pueyrredón,11,4658,4436,9094,edad 10
06357,General Pueyrredón,12,4621,4488,9109,edad 10
06357,General Pueyrredón,13,4731,4433,9164,edad 10
06357,General Pueyrredón,14,4755,4582,9337,edad 10
06357,General Pueyrredón,15,4666,4442,9108,edad 10
06357,General Pueyrredón,16,4339,4292,8631,edad 10
06357,General Pueyrredón,17,4466,4274,8740,edad 10
06357,General Pueyrredón,18,4421,4454,8875,edad 10
06357,General Pueyrredón,19,4524,4545,9069,edad 10
06357,General Pueyrredón,20,4750,4571,9321,edad 20
06357,General Pueyrredón,21,4725,4654,9379,edad 20
06357,General Pueyrredón,22,4333,4593,8926,edad 20
06357,General Pueyrredón,23,4284,4351,8635,edad 20
06357,General Pueyrredón,24,4217,4470,8687,edad 20
06357,General Pueyrredón,25,4164,4305,8469,edad 20
06357,General Pueyrredón,26,4129,4208,8337,edad 20
06357,General Pueyrredón,27,3965,4051,8016,edad 20
06357,General Pueyrredón,28,3756,3926,7682,edad 20
06357,General Pueyrredón,29,3605,3899,7504,edad 20
06357,General Pueyrredón,30,3967,4111,8078,edad 30
06357,General Pueyrredón,31,3477,3712,7189,edad 30
06357,General Pueyrredón,32,3446,3742,7188,edad 30
06357,General Pueyrredón,33,3385,3612,6997,edad 30
06357,General Pueyrredón,34,3204,3524,6728,edad 30
06357,General Pueyrredón,35,3313,3516,6829,edad 30
06357,General Pueyrredón,36,3314,3797,7111,edad 30
06357,General Pueyrredón,37,3347,3614,6961,edad 30
06357,General Pueyrredón,38,3535,3625,7160,edad 30
06357,General Pueyrredón,39,3245,3589,6834,edad 30
06357,General Pueyrredón,40,3413,3870,7283,edad 40
06357,General Pueyrredón,41,3278,3601,6879,edad 40
06357,General Pueyrredón,42,3427,3721,7148,edad 40
06357,General Pueyrredón,43,3463,3802,7265,edad 40
06357,General Pueyrredón,44,3075,3494,6569,edad 40
06357,General Pueyrredón,45,3306,3654,6960,edad 40
06357,General Pueyrredón,46,3160,3556,6716,edad 40
06357,General Pueyrredón,47,3125,3493,6618,edad 40
06357,General Pueyrredón,48,3168,3442,6610,edad 40
06357,General Pueyrredón,49,2987,3284,6271,edad 40
06357,General Pueyrredón,50,3196,3810,7006,edad 50
06357,General Pueyrredón,51,3037,3563,6600,edad 50
06357,General Pueyrredón,52,3006,3438,6444,edad 50
06357,General Pueyrredón,53,2972,3400,6372,edad 50
06357,General Pueyrredón,54,2768,3417,6185,edad 50
06357,General Pueyrredón,55,2700,3235,5935,edad 50
06357,General Pueyrredón,56,2882,3314,6196,edad 50
06357,General Pueyrredón,57,2440,2973,5413,edad 50
06357,General Pueyrredón,58,2394,2887,5281,edad 50
06357,General Pueyrredón,59,2155,2589,4744,edad 50
06357,General Pueyrredón,60,2355,3222,5577,edad 60
06357,General Pueyrredón,61,2174,2687,4861,edad 60
06357,General Pueyrredón,62,2192,2764,4956,edad 60
06357,General Pueyrredón,63,2145,2670,4815,edad 60
06357,General Pueyrredón,64,1971,2576,4547,edad 60
06357,General Pueyrredón,65,2089,2773,4862,edad 60
06357,General Pueyrredón,66,1833,2581,4414,edad 60
06357,General Pueyrredón,67,1844,2479,4323,edad 60
06357,General Pueyrredón,68,1933,2682,4615,edad 60
06357,General Pueyrredón,69,1861,2516,4377,edad 60
06357,General Pueyrredón,70,2059,2891,4950,edad 70
06357,General Pueyrredón,71,1875,2497,4372,edad 70
06357,General Pueyrredón,72,1810,2621,4431,edad 70
06357,General Pueyrredón,73,1747,2450,4197,edad 70
06357,General Pueyrredón,74,1625,2351,3976,edad 70
06357,General Pueyrredón,75,1582,2388,3970,edad 70
06357,General Pueyrredón,76,1487,2167,3654,edad 70
06357,General Pueyrredón,77,1286,2028,3314,edad 70
06357,General Pueyrredón,78,1241,1902,3143,edad 70
06357,General Pueyrredón,79,1042,1652,2694,edad 70
06357,General Pueyrredón,80,1014,1689,2703,edad 80
06357,General Pueyrredón,81,820,1363,2183,edad 80
06357,General Pueyrredón,82,706,1252,1958,edad 80
06357,General Pueyrredón,83,555,1118,1673,edad 80
06357,General Pueyrredón,84,468,1000,1468,edad 80
06357,General Pueyrredón,85,439,861,1300,edad 80
06357,General Pueyrredón,86,365,802,1167,edad 80
06357,General Pueyrredón,87,304,723,1027,edad 80
06357,General Pueyrredón,88,248,507,755,edad 80
06357,General Pueyrredón,89,199,469,668,edad 80
06357,General Pueyrredón,90,176,452,628,edad 90
06357,General Pueyrredón,91,104,286,390,edad 90
06357,General Pueyrredón,92,79,228,307,edad 90
06357,General Pueyrredón,93,74,184,258,edad 90
06357,General Pueyrredón,94,42,114,156,edad 90
06357,General Pueyrredón,95,32,88,120,edad 90
06357,General Pueyrredón,96,18,67,85,edad 90
06357,General Pueyrredón,97,12,50,62,edad 90
06357,General Pueyrredón,98,7,29,36,edad 90
06357,General Pueyrredón,99,1,20,21,edad 90
06364,General Rodríguez,0,769,714,1483,edad 0
06364,General Rodríguez,1,700,681,1381,edad 0
06364,General Rodríguez,2,751,793,1544,edad 0
06364,General Rodríguez,3,751,780,1531,edad 0
06364,General Rodríguez,4,774,820,1594,edad 0
06364,General Rodríguez,5,819,795,1614,edad 0
06364,General Rodríguez,6,791,787,1578,edad 0
06364,General Rodríguez,7,783,744,1527,edad 0
06364,General Rodríguez,8,734,685,1419,edad 0
06364,General Rodríguez,9,736,715,1451,edad 0
06364,General Rodríguez,10,789,718,1507,edad 10
06364,General Rodríguez,11,724,705,1429,edad 10
06364,General Rodríguez,12,727,647,1374,edad 10
06364,General Rodríguez,13,690,659,1349,edad 10
06364,General Rodríguez,14,655,690,1345,edad 10
06364,General Rodríguez,15,674,635,1309,edad 10
06364,General Rodríguez,16,611,617,1228,edad 10
06364,General Rodríguez,17,592,595,1187,edad 10
06364,General Rodríguez,18,595,588,1183,edad 10
06364,General Rodríguez,19,654,643,1297,edad 10
06364,General Rodríguez,20,611,586,1197,edad 20
06364,General Rodríguez,21,594,616,1210,edad 20
06364,General Rodríguez,22,600,604,1204,edad 20
06364,General Rodríguez,23,593,582,1175,edad 20
06364,General Rodríguez,24,564,586,1150,edad 20
06364,General Rodríguez,25,517,544,1061,edad 20
06364,General Rodríguez,26,475,531,1006,edad 20
06364,General Rodríguez,27,502,513,1015,edad 20
06364,General Rodríguez,28,478,514,992,edad 20
06364,General Rodríguez,29,439,458,897,edad 20
06364,General Rodríguez,30,516,500,1016,edad 30
06364,General Rodríguez,31,457,467,924,edad 30
06364,General Rodríguez,32,424,482,906,edad 30
06364,General Rodríguez,33,400,469,869,edad 30
06364,General Rodríguez,34,397,367,764,edad 30
06364,General Rodríguez,35,429,421,850,edad 30
06364,General Rodríguez,36,396,414,810,edad 30
06364,General Rodríguez,37,434,422,856,edad 30
06364,General Rodríguez,38,413,429,842,edad 30
06364,General Rodríguez,39,384,398,782,edad 30
06364,General Rodríguez,40,441,431,872,edad 40
06364,General Rodríguez,41,440,395,835,edad 40
06364,General Rodríguez,42,418,422,840,edad 40
06364,General Rodríguez,43,392,370,762,edad 40
06364,General Rodríguez,44,371,373,744,edad 40
06364,General Rodríguez,45,379,367,746,edad 40
06364,General Rodríguez,46,383,352,735,edad 40
06364,General Rodríguez,47,363,365,728,edad 40
06364,General Rodríguez,48,338,338,676,edad 40
06364,General Rodríguez,49,350,328,678,edad 40
06364,General Rodríguez,50,388,382,770,edad 50
06364,General Rodríguez,51,335,297,632,edad 50
06364,General Rodríguez,52,305,291,596,edad 50
06364,General Rodríguez,53,263,290,553,edad 50
06364,General Rodríguez,54,291,265,556,edad 50
06364,General Rodríguez,55,251,237,488,edad 50
06364,General Rodríguez,56,315,298,613,edad 50
06364,General Rodríguez,57,215,229,444,edad 50
06364,General Rodríguez,58,243,250,493,edad 50
06364,General Rodríguez,59,206,204,410,edad 50
06364,General Rodríguez,60,212,218,430,edad 60
06364,General Rodríguez,61,202,197,399,edad 60
06364,General Rodríguez,62,185,197,382,edad 60
06364,General Rodríguez,63,174,179,353,edad 60
06364,General Rodríguez,64,180,171,351,edad 60
06364,General Rodríguez,65,159,209,368,edad 60
06364,General Rodríguez,66,139,162,301,edad 60
06364,General Rodríguez,67,147,145,292,edad 60
06364,General Rodríguez,68,171,181,352,edad 60
06364,General Rodríguez,69,141,158,299,edad 60
06364,General Rodríguez,70,137,181,318,edad 70
06364,General Rodríguez,71,112,168,280,edad 70
06364,General Rodríguez,72,143,166,309,edad 70
06364,General Rodríguez,73,130,144,274,edad 70
06364,General Rodríguez,74,112,144,256,edad 70
06364,General Rodríguez,75,91,146,237,edad 70
06364,General Rodríguez,76,108,136,244,edad 70
06364,General Rodríguez,77,87,89,176,edad 70
06364,General Rodríguez,78,73,127,200,edad 70
06364,General Rodríguez,79,54,79,133,edad 70
06364,General Rodríguez,80,62,103,165,edad 80
06364,General Rodríguez,81,49,68,117,edad 80
06364,General Rodríguez,82,42,72,114,edad 80
06364,General Rodríguez,83,37,54,91,edad 80
06364,General Rodríguez,84,27,41,68,edad 80
06364,General Rodríguez,85,27,55,82,edad 80
06364,General Rodríguez,86,18,57,75,edad 80
06364,General Rodríguez,87,15,35,50,edad 80
06364,General Rodríguez,88,10,30,40,edad 80
06364,General Rodríguez,89,16,24,40,edad 80
06364,General Rodríguez,90,12,16,28,edad 90
06364,General Rodríguez,91,2,16,18,edad 90
06364,General Rodríguez,92,2,9,11,edad 90
06364,General Rodríguez,93,2,12,14,edad 90
06364,General Rodríguez,94,1,12,13,edad 90
06364,General Rodríguez,95,1,5,6,edad 90
06364,General Rodríguez,96,1,3,4,edad 90
06364,General Rodríguez,97,1,4,5,edad 90
06364,General Rodríguez,98,0,2,2,edad 90
06385,General Viamonte,0,130,115,245,edad 0
06385,General Viamonte,1,133,117,250,edad 0
06385,General Viamonte,2,145,125,270,edad 0
06385,General Viamonte,3,133,142,275,edad 0
06385,General Viamonte,4,154,127,281,edad 0
06385,General Viamonte,5,157,140,297,edad 0
06385,General Viamonte,6,140,149,289,edad 0
06385,General Viamonte,7,169,134,303,edad 0
06385,General Viamonte,8,136,152,288,edad 0
06385,General Viamonte,9,162,161,323,edad 0
06385,General Viamonte,10,145,171,316,edad 10
06385,General Viamonte,11,146,168,314,edad 10
06385,General Viamonte,12,149,149,298,edad 10
06385,General Viamonte,13,149,144,293,edad 10
06385,General Viamonte,14,170,153,323,edad 10
06385,General Viamonte,15,153,174,327,edad 10
06385,General Viamonte,16,161,164,325,edad 10
06385,General Viamonte,17,132,135,267,edad 10
06385,General Viamonte,18,162,161,323,edad 10
06385,General Viamonte,19,150,130,280,edad 10
06385,General Viamonte,20,155,153,308,edad 20
06385,General Viamonte,21,149,127,276,edad 20
06385,General Viamonte,22,133,146,279,edad 20
06385,General Viamonte,23,138,123,261,edad 20
06385,General Viamonte,24,100,106,206,edad 20
06385,General Viamonte,25,120,108,228,edad 20
06385,General Viamonte,26,107,91,198,edad 20
06385,General Viamonte,27,89,95,184,edad 20
06385,General Viamonte,28,83,103,186,edad 20
06385,General Viamonte,29,97,123,220,edad 20
06385,General Viamonte,30,100,95,195,edad 30
06385,General Viamonte,31,120,126,246,edad 30
06385,General Viamonte,32,108,111,219,edad 30
06385,General Viamonte,33,89,105,194,edad 30
06385,General Viamonte,34,96,90,186,edad 30
06385,General Viamonte,35,77,95,172,edad 30
06385,General Viamonte,36,98,120,218,edad 30
06385,General Viamonte,37,104,96,200,edad 30
06385,General Viamonte,38,107,96,203,edad 30
06385,General Viamonte,39,93,102,195,edad 30
06385,General Viamonte,40,96,113,209,edad 40
06385,General Viamonte,41,76,107,183,edad 40
06385,General Viamonte,42,106,97,203,edad 40
06385,General Viamonte,43,94,91,185,edad 40
06385,General Viamonte,44,100,88,188,edad 40
06385,General Viamonte,45,106,104,210,edad 40
06385,General Viamonte,46,83,107,190,edad 40
06385,General Viamonte,47,97,83,180,edad 40
06385,General Viamonte,48,76,107,183,edad 40
06385,General Viamonte,49,94,112,206,edad 40
06385,General Viamonte,50,120,102,222,edad 50
06385,General Viamonte,51,96,104,200,edad 50
06385,General Viamonte,52,97,105,202,edad 50
06385,General Viamonte,53,108,113,221,edad 50
06385,General Viamonte,54,104,109,213,edad 50
06385,General Viamonte,55,84,89,173,edad 50
06385,General Viamonte,56,111,111,222,edad 50
06385,General Viamonte,57,86,99,185,edad 50
06385,General Viamonte,58,98,77,175,edad 50
06385,General Viamonte,59,67,85,152,edad 50
06385,General Viamonte,60,82,102,184,edad 60
06385,General Viamonte,61,82,81,163,edad 60
06385,General Viamonte,62,94,70,164,edad 60
06385,General Viamonte,63,85,89,174,edad 60
06385,General Viamonte,64,96,67,163,edad 60
06385,General Viamonte,65,84,106,190,edad 60
06385,General Viamonte,66,64,71,135,edad 60
06385,General Viamonte,67,73,69,142,edad 60
06385,General Viamonte,68,76,70,146,edad 60
06385,General Viamonte,69,58,88,146,edad 60
06385,General Viamonte,70,71,93,164,edad 70
06385,General Viamonte,71,57,81,138,edad 70
06385,General Viamonte,72,47,77,124,edad 70
06385,General Viamonte,73,56,89,145,edad 70
06385,General Viamonte,74,66,62,128,edad 70
06385,General Viamonte,75,47,71,118,edad 70
06385,General Viamonte,76,45,60,105,edad 70
06385,General Viamonte,77,34,51,85,edad 70
06385,General Viamonte,78,39,60,99,edad 70
06385,General Viamonte,79,44,45,89,edad 70
06385,General Viamonte,80,34,50,84,edad 80
06385,General Viamonte,81,23,55,78,edad 80
06385,General Viamonte,82,23,56,79,edad 80
06385,General Viamonte,83,33,34,67,edad 80
06385,General Viamonte,84,18,39,57,edad 80
06385,General Viamonte,85,19,35,54,edad 80
06385,General Viamonte,86,23,30,53,edad 80
06385,General Viamonte,87,15,29,44,edad 80
06385,General Viamonte,88,12,30,42,edad 80
06385,General Viamonte,89,9,20,29,edad 80
06385,General Viamonte,90,11,18,29,edad 90
06385,General Viamonte,91,7,6,13,edad 90
06385,General Viamonte,92,5,14,19,edad 90
06385,General Viamonte,93,3,5,8,edad 90
06385,General Viamonte,94,4,2,6,edad 90
06385,General Viamonte,95,0,2,2,edad 90
06385,General Viamonte,96,1,3,4,edad 90
06385,General Viamonte,97,1,3,4,edad 90
06385,General Viamonte,98,0,2,2,edad 90
06385,General Viamonte,99,0,1,1,edad 90
06392,General Villegas,0,251,248,499,edad 0
06392,General Villegas,1,237,222,459,edad 0
06392,General Villegas,2,304,258,562,edad 0
06392,General Villegas,3,268,257,525,edad 0
06392,General Villegas,4,277,298,575,edad 0
06392,General Villegas,5,257,287,544,edad 0
06392,General Villegas,6,273,253,526,edad 0
06392,General Villegas,7,288,237,525,edad 0
06392,General Villegas,8,261,275,536,edad 0
06392,General Villegas,9,272,303,575,edad 0
06392,General Villegas,10,316,291,607,edad 10
06392,General Villegas,11,246,310,556,edad 10
06392,General Villegas,12,247,282,529,edad 10
06392,General Villegas,13,265,247,512,edad 10
06392,General Villegas,14,269,268,537,edad 10
06392,General Villegas,15,221,262,483,edad 10
06392,General Villegas,16,273,258,531,edad 10
06392,General Villegas,17,248,251,499,edad 10
06392,General Villegas,18,243,208,451,edad 10
06392,General Villegas,19,208,189,397,edad 10
06392,General Villegas,20,214,195,409,edad 20
06392,General Villegas,21,208,200,408,edad 20
06392,General Villegas,22,179,188,367,edad 20
06392,General Villegas,23,191,204,395,edad 20
06392,General Villegas,24,193,186,379,edad 20
06392,General Villegas,25,163,193,356,edad 20
06392,General Villegas,26,206,202,408,edad 20
06392,General Villegas,27,174,190,364,edad 20
06392,General Villegas,28,196,191,387,edad 20
06392,General Villegas,29,194,169,363,edad 20
06392,General Villegas,30,183,190,373,edad 30
06392,General Villegas,31,166,181,347,edad 30
06392,General Villegas,32,185,176,361,edad 30
06392,General Villegas,33,196,172,368,edad 30
06392,General Villegas,34,169,177,346,edad 30
06392,General Villegas,35,196,192,388,edad 30
06392,General Villegas,36,236,181,417,edad 30
06392,General Villegas,37,199,192,391,edad 30
06392,General Villegas,38,223,165,388,edad 30
06392,General Villegas,39,163,157,320,edad 30
06392,General Villegas,40,170,193,363,edad 40
06392,General Villegas,41,167,163,330,edad 40
06392,General Villegas,42,184,176,360,edad 40
06392,General Villegas,43,197,179,376,edad 40
06392,General Villegas,44,161,160,321,edad 40
06392,General Villegas,45,171,174,345,edad 40
06392,General Villegas,46,185,153,338,edad 40
06392,General Villegas,47,197,150,347,edad 40
06392,General Villegas,48,178,158,336,edad 40
06392,General Villegas,49,161,159,320,edad 40
06392,General Villegas,50,167,152,319,edad 50
06392,General Villegas,51,150,141,291,edad 50
06392,General Villegas,52,146,170,316,edad 50
06392,General Villegas,53,140,168,308,edad 50
06392,General Villegas,54,142,145,287,edad 50
06392,General Villegas,55,145,146,291,edad 50
06392,General Villegas,56,150,153,303,edad 50
06392,General Villegas,57,149,135,284,edad 50
06392,General Villegas,58,143,130,273,edad 50
06392,General Villegas,59,138,134,272,edad 50
06392,General Villegas,60,165,137,302,edad 60
06392,General Villegas,61,122,125,247,edad 60
06392,General Villegas,62,131,104,235,edad 60
06392,General Villegas,63,147,127,274,edad 60
06392,General Villegas,64,111,138,249,edad 60
06392,General Villegas,65,136,119,255,edad 60
06392,General Villegas,66,109,106,215,edad 60
06392,General Villegas,67,110,93,203,edad 60
06392,General Villegas,68,86,92,178,edad 60
06392,General Villegas,69,96,104,200,edad 60
06392,General Villegas,70,90,109,199,edad 70
06392,General Villegas,71,86,93,179,edad 70
06392,General Villegas,72,123,90,213,edad 70
06392,General Villegas,73,80,89,169,edad 70
06392,General Villegas,74,62,81,143,edad 70
06392,General Villegas,75,51,99,150,edad 70
06392,General Villegas,76,66,73,139,edad 70
06392,General Villegas,77,66,66,132,edad 70
06392,General Villegas,78,44,70,114,edad 70
06392,General Villegas,79,42,68,110,edad 70
06392,General Villegas,80,51,57,108,edad 80
06392,General Villegas,81,28,52,80,edad 80
06392,General Villegas,82,31,51,82,edad 80
06392,General Villegas,83,31,41,72,edad 80
06392,General Villegas,84,24,45,69,edad 80
06392,General Villegas,85,16,49,65,edad 80
06392,General Villegas,86,15,46,61,edad 80
06392,General Villegas,87,15,28,43,edad 80
06392,General Villegas,88,9,25,34,edad 80
06392,General Villegas,89,4,16,20,edad 80
06392,General Villegas,90,3,17,20,edad 90
06392,General Villegas,91,10,8,18,edad 90
06392,General Villegas,92,5,9,14,edad 90
06392,General Villegas,93,1,6,7,edad 90
06392,General Villegas,94,2,5,7,edad 90
06392,General Villegas,95,0,4,4,edad 90
06392,General Villegas,97,0,2,2,edad 90
06392,General Villegas,99,1,3,4,edad 90
06399,Guaminí,0,79,92,171,edad 0
06399,Guaminí,1,83,81,164,edad 0
06399,Guaminí,2,70,79,149,edad 0
06399,Guaminí,3,99,78,177,edad 0
06399,Guaminí,4,90,80,170,edad 0
06399,Guaminí,5,115,82,197,edad 0
06399,Guaminí,6,100,79,179,edad 0
06399,Guaminí,7,91,77,168,edad 0
06399,Guaminí,8,97,83,180,edad 0
06399,Guaminí,9,98,103,201,edad 0
06399,Guaminí,10,88,102,190,edad 10
06399,Guaminí,11,109,74,183,edad 10
06399,Guaminí,12,83,79,162,edad 10
06399,Guaminí,13,71,82,153,edad 10
06399,Guaminí,14,90,87,177,edad 10
06399,Guaminí,15,81,87,168,edad 10
06399,Guaminí,16,81,99,180,edad 10
06399,Guaminí,17,90,95,185,edad 10
06399,Guaminí,18,92,70,162,edad 10
06399,Guaminí,19,63,65,128,edad 10
06399,Guaminí,20,67,65,132,edad 20
06399,Guaminí,21,81,72,153,edad 20
06399,Guaminí,22,87,78,165,edad 20
06399,Guaminí,23,75,74,149,edad 20
06399,Guaminí,24,80,57,137,edad 20
06399,Guaminí,25,89,77,166,edad 20
06399,Guaminí,26,71,61,132,edad 20
06399,Guaminí,27,71,59,130,edad 20
06399,Guaminí,28,78,76,154,edad 20
06399,Guaminí,29,62,94,156,edad 20
06399,Guaminí,30,50,79,129,edad 30
06399,Guaminí,31,59,65,124,edad 30
06399,Guaminí,32,69,61,130,edad 30
06399,Guaminí,33,77,64,141,edad 30
06399,Guaminí,34,72,62,134,edad 30
06399,Guaminí,35,62,73,135,edad 30
06399,Guaminí,36,72,72,144,edad 30
06399,Guaminí,37,70,86,156,edad 30
06399,Guaminí,38,64,73,137,edad 30
06399,Guaminí,39,72,68,140,edad 30
06399,Guaminí,40,79,66,145,edad 40
06399,Guaminí,41,84,59,143,edad 40
06399,Guaminí,42,74,76,150,edad 40
06399,Guaminí,43,64,68,132,edad 40
06399,Guaminí,44,63,89,152,edad 40
06399,Guaminí,45,88,71,159,edad 40
06399,Guaminí,46,77,74,151,edad 40
06399,Guaminí,47,79,66,145,edad 40
06399,Guaminí,48,73,61,134,edad 40
06399,Guaminí,49,72,62,134,edad 40
06399,Guaminí,50,85,71,156,edad 50
06399,Guaminí,51,76,77,153,edad 50
06399,Guaminí,52,62,79,141,edad 50
06399,Guaminí,53,63,64,127,edad 50
06399,Guaminí,54,86,69,155,edad 50
06399,Guaminí,55,80,68,148,edad 50
06399,Guaminí,56,58,74,132,edad 50
06399,Guaminí,57,54,56,110,edad 50
06399,Guaminí,58,67,46,113,edad 50
06399,Guaminí,59,61,43,104,edad 50
06399,Guaminí,60,59,51,110,edad 60
06399,Guaminí,61,70,45,115,edad 60
06399,Guaminí,62,56,61,117,edad 60
06399,Guaminí,63,59,61,120,edad 60
06399,Guaminí,64,47,42,89,edad 60
06399,Guaminí,65,61,45,106,edad 60
06399,Guaminí,66,51,41,92,edad 60
06399,Guaminí,67,52,55,107,edad 60
06399,Guaminí,68,46,40,86,edad 60
06399,Guaminí,69,53,40,93,edad 60
06399,Guaminí,70,40,54,94,edad 70
06399,Guaminí,71,34,36,70,edad 70
06399,Guaminí,72,41,47,88,edad 70
06399,Guaminí,73,36,48,84,edad 70
06399,Guaminí,74,34,49,83,edad 70
06399,Guaminí,75,31,49,80,edad 70
06399,Guaminí,76,39,39,78,edad 70
06399,Guaminí,77,24,39,63,edad 70
06399,Guaminí,78,30,44,74,edad 70
06399,Guaminí,79,23,38,61,edad 70
06399,Guaminí,80,23,32,55,edad 80
06399,Guaminí,81,16,24,40,edad 80
06399,Guaminí,82,18,23,41,edad 80
06399,Guaminí,83,18,28,46,edad 80
06399,Guaminí,84,13,23,36,edad 80
06399,Guaminí,85,19,15,34,edad 80
06399,Guaminí,86,9,20,29,edad 80
06399,Guaminí,87,6,9,15,edad 80
06399,Guaminí,88,5,10,15,edad 80
06399,Guaminí,89,5,13,18,edad 80
06399,Guaminí,90,2,11,13,edad 90
06399,Guaminí,91,2,5,7,edad 90
06399,Guaminí,92,3,4,7,edad 90
06399,Guaminí,93,3,7,10,edad 90
06399,Guaminí,94,0,4,4,edad 90
06399,Guaminí,95,1,3,4,edad 90
06399,Guaminí,97,1,0,1,edad 90
06406,Hipólito Yrigoyen,0,72,65,137,edad 0
06406,Hipólito Yrigoyen,1,70,73,143,edad 0
06406,Hipólito Yrigoyen,2,71,74,145,edad 0
06406,Hipólito Yrigoyen,3,81,81,162,edad 0
06406,Hipólito Yrigoyen,4,83,73,156,edad 0
06406,Hipólito Yrigoyen,5,83,54,137,edad 0
06406,Hipólito Yrigoyen,6,87,79,166,edad 0
06406,Hipólito Yrigoyen,7,78,77,155,edad 0
06406,Hipólito Yrigoyen,8,82,68,150,edad 0
06406,Hipólito Yrigoyen,9,86,90,176,edad 0
06406,Hipólito Yrigoyen,10,95,76,171,edad 10
06406,Hipólito Yrigoyen,11,78,80,158,edad 10
06406,Hipólito Yrigoyen,12,69,78,147,edad 10
06406,Hipólito Yrigoyen,13,64,64,128,edad 10
06406,Hipólito Yrigoyen,14,73,60,133,edad 10
06406,Hipólito Yrigoyen,15,81,69,150,edad 10
06406,Hipólito Yrigoyen,16,61,57,118,edad 10
06406,Hipólito Yrigoyen,17,61,69,130,edad 10
06406,Hipólito Yrigoyen,18,69,54,123,edad 10
06406,Hipólito Yrigoyen,19,62,49,111,edad 10
06406,Hipólito Yrigoyen,20,59,48,107,edad 20
06406,Hipólito Yrigoyen,21,58,60,118,edad 20
06406,Hipólito Yrigoyen,22,61,51,112,edad 20
06406,Hipólito Yrigoyen,23,42,53,95,edad 20
06406,Hipólito Yrigoyen,24,63,61,124,edad 20
06406,Hipólito Yrigoyen,25,44,69,113,edad 20
06406,Hipólito Yrigoyen,26,50,59,109,edad 20
06406,Hipólito Yrigoyen,27,62,50,112,edad 20
06406,Hipólito Yrigoyen,28,60,60,120,edad 20
06406,Hipólito Yrigoyen,29,55,56,111,edad 20
06406,Hipólito Yrigoyen,30,56,68,124,edad 30
06406,Hipólito Yrigoyen,31,35,65,100,edad 30
06406,Hipólito Yrigoyen,32,52,48,100,edad 30
06406,Hipólito Yrigoyen,33,65,54,119,edad 30
06406,Hipólito Yrigoyen,34,55,47,102,edad 30
06406,Hipólito Yrigoyen,35,56,48,104,edad 30
06406,Hipólito Yrigoyen,36,46,44,90,edad 30
06406,Hipólito Yrigoyen,37,47,52,99,edad 30
06406,Hipólito Yrigoyen,38,49,52,101,edad 30
06406,Hipólito Yrigoyen,39,53,50,103,edad 30
06406,Hipólito Yrigoyen,40,57,59,116,edad 40
06406,Hipólito Yrigoyen,41,53,62,115,edad 40
06406,Hipólito Yrigoyen,42,51,60,111,edad 40
06406,Hipólito Yrigoyen,43,54,60,114,edad 40
06406,Hipólito Yrigoyen,44,44,46,90,edad 40
06406,Hipólito Yrigoyen,45,52,46,98,edad 40
06406,Hipólito Yrigoyen,46,58,54,112,edad 40
06406,Hipólito Yrigoyen,47,50,50,100,edad 40
06406,Hipólito Yrigoyen,48,63,60,123,edad 40
06406,Hipólito Yrigoyen,49,40,44,84,edad 40
06406,Hipólito Yrigoyen,50,49,51,100,edad 50
06406,Hipólito Yrigoyen,51,42,50,92,edad 50
06406,Hipólito Yrigoyen,52,49,54,103,edad 50
06406,Hipólito Yrigoyen,53,46,62,108,edad 50
06406,Hipólito Yrigoyen,54,44,42,86,edad 50
06406,Hipólito Yrigoyen,55,49,40,89,edad 50
06406,Hipólito Yrigoyen,56,59,46,105,edad 50
06406,Hipólito Yrigoyen,57,57,45,102,edad 50
06406,Hipólito Yrigoyen,58,51,59,110,edad 50
06406,Hipólito Yrigoyen,59,56,41,97,edad 50
06406,Hipólito Yrigoyen,60,39,48,87,edad 60
06406,Hipólito Yrigoyen,61,53,34,87,edad 60
06406,Hipólito Yrigoyen,62,41,39,80,edad 60
06406,Hipólito Yrigoyen,63,45,40,85,edad 60
06406,Hipólito Yrigoyen,64,48,43,91,edad 60
06406,Hipólito Yrigoyen,65,47,41,88,edad 60
06406,Hipólito Yrigoyen,66,31,49,80,edad 60
06406,Hipólito Yrigoyen,67,40,29,69,edad 60
06406,Hipólito Yrigoyen,68,36,30,66,edad 60
06406,Hipólito Yrigoyen,69,31,31,62,edad 60
06406,Hipólito Yrigoyen,70,42,42,84,edad 70
06406,Hipólito Yrigoyen,71,24,42,66,edad 70
06406,Hipólito Yrigoyen,72,30,36,66,edad 70
06406,Hipólito Yrigoyen,73,24,39,63,edad 70
06406,Hipólito Yrigoyen,74,28,26,54,edad 70
06406,Hipólito Yrigoyen,75,19,27,46,edad 70
06406,Hipólito Yrigoyen,76,32,34,66,edad 70
06406,Hipólito Yrigoyen,77,20,34,54,edad 70
06406,Hipólito Yrigoyen,78,17,35,52,edad 70
06406,Hipólito Yrigoyen,79,12,22,34,edad 70
06406,Hipólito Yrigoyen,80,10,35,45,edad 80
06406,Hipólito Yrigoyen,81,11,27,38,edad 80
06406,Hipólito Yrigoyen,82,11,19,30,edad 80
06406,Hipólito Yrigoyen,83,8,22,30,edad 80
06406,Hipólito Yrigoyen,84,17,21,38,edad 80
06406,Hipólito Yrigoyen,85,5,22,27,edad 80
06406,Hipólito Yrigoyen,86,11,20,31,edad 80
06406,Hipólito Yrigoyen,87,10,11,21,edad 80
06406,Hipólito Yrigoyen,88,3,13,16,edad 80
06406,Hipólito Yrigoyen,89,1,5,6,edad 80
06406,Hipólito Yrigoyen,90,5,8,13,edad 90
06406,Hipólito Yrigoyen,91,3,3,6,edad 90
06406,Hipólito Yrigoyen,92,2,3,5,edad 90
06406,Hipólito Yrigoyen,93,2,2,4,edad 90
06406,Hipólito Yrigoyen,94,1,6,7,edad 90
06406,Hipólito Yrigoyen,95,0,2,2,edad 90
06406,Hipólito Yrigoyen,96,1,0,1,edad 90
06406,Hipólito Yrigoyen,97,1,2,3,edad 90
06406,Hipólito Yrigoyen,98,0,2,2,edad 90
06413,Junín,0,683,592,1275,edad 0
06413,Junín,1,598,596,1194,edad 0
06413,Junín,2,649,651,1300,edad 0
06413,Junín,3,670,671,1341,edad 0
06413,Junín,4,648,637,1285,edad 0
06413,Junín,5,682,695,1377,edad 0
06413,Junín,6,691,683,1374,edad 0
06413,Junín,7,651,691,1342,edad 0
06413,Junín,8,691,664,1355,edad 0
06413,Junín,9,682,711,1393,edad 0
06413,Junín,10,741,728,1469,edad 10
06413,Junín,11,743,733,1476,edad 10
06413,Junín,12,695,686,1381,edad 10
06413,Junín,13,728,664,1392,edad 10
06413,Junín,14,731,754,1485,edad 10
06413,Junín,15,733,721,1454,edad 10
06413,Junín,16,799,692,1491,edad 10
06413,Junín,17,763,734,1497,edad 10
06413,Junín,18,726,653,1379,edad 10
06413,Junín,19,719,728,1447,edad 10
06413,Junín,20,775,693,1468,edad 20
06413,Junín,21,737,707,1444,edad 20
06413,Junín,22,745,681,1426,edad 20
06413,Junín,23,708,704,1412,edad 20
06413,Junín,24,662,627,1289,edad 20
06413,Junín,25,614,597,1211,edad 20
06413,Junín,26,577,565,1142,edad 20
06413,Junín,27,614,562,1176,edad 20
06413,Junín,28,551,600,1151,edad 20
06413,Junín,29,534,498,1032,edad 20
06413,Junín,30,559,537,1096,edad 30
06413,Junín,31,520,532,1052,edad 30
06413,Junín,32,523,520,1043,edad 30
06413,Junín,33,483,536,1019,edad 30
06413,Junín,34,489,494,983,edad 30
06413,Junín,35,521,540,1061,edad 30
06413,Junín,36,510,540,1050,edad 30
06413,Junín,37,511,558,1069,edad 30
06413,Junín,38,522,546,1068,edad 30
06413,Junín,39,508,556,1064,edad 30
06413,Junín,40,510,576,1086,edad 40
06413,Junín,41,489,514,1003,edad 40
06413,Junín,42,534,586,1120,edad 40
06413,Junín,43,481,579,1060,edad 40
06413,Junín,44,481,536,1017,edad 40
06413,Junín,45,563,537,1100,edad 40
06413,Junín,46,465,568,1033,edad 40
06413,Junín,47,515,518,1033,edad 40
06413,Junín,48,483,556,1039,edad 40
06413,Junín,49,490,497,987,edad 40
06413,Junín,50,579,570,1149,edad 50
06413,Junín,51,474,554,1028,edad 50
06413,Junín,52,502,552,1054,edad 50
06413,Junín,53,453,511,964,edad 50
06413,Junín,54,412,438,850,edad 50
06413,Junín,55,406,483,889,edad 50
06413,Junín,56,479,551,1030,edad 50
06413,Junín,57,374,465,839,edad 50
06413,Junín,58,372,418,790,edad 50
06413,Junín,59,314,412,726,edad 50
06413,Junín,60,365,464,829,edad 60
06413,Junín,61,354,400,754,edad 60
06413,Junín,62,342,423,765,edad 60
06413,Junín,63,401,438,839,edad 60
06413,Junín,64,339,439,778,edad 60
06413,Junín,65,407,482,889,edad 60
06413,Junín,66,330,416,746,edad 60
06413,Junín,67,344,411,755,edad 60
06413,Junín,68,343,460,803,edad 60
06413,Junín,69,321,442,763,edad 60
06413,Junín,70,347,490,837,edad 70
06413,Junín,71,296,470,766,edad 70
06413,Junín,72,333,501,834,edad 70
06413,Junín,73,314,420,734,edad 70
06413,Junín,74,298,421,719,edad 70
06413,Junín,75,265,375,640,edad 70
06413,Junín,76,260,422,682,edad 70
06413,Junín,77,253,367,620,edad 70
06413,Junín,78,217,342,559,edad 70
06413,Junín,79,173,289,462,edad 70
06413,Junín,80,171,318,489,edad 80
06413,Junín,81,140,224,364,edad 80
06413,Junín,82,119,229,348,edad 80
06413,Junín,83,103,188,291,edad 80
06413,Junín,84,100,198,298,edad 80
06413,Junín,85,77,175,252,edad 80
06413,Junín,86,74,172,246,edad 80
06413,Junín,87,41,141,182,edad 80
06413,Junín,88,39,102,141,edad 80
06413,Junín,89,46,84,130,edad 80
06413,Junín,90,32,74,106,edad 90
06413,Junín,91,22,53,75,edad 90
06413,Junín,92,12,40,52,edad 90
06413,Junín,93,18,35,53,edad 90
06413,Junín,94,5,25,30,edad 90
06413,Junín,95,10,15,25,edad 90
06413,Junín,96,4,11,15,edad 90
06413,Junín,97,3,8,11,edad 90
06413,Junín,98,0,7,7,edad 90
06413,Junín,99,2,6,8,edad 90
06420,La Costa,0,541,509,1050,edad 0
06420,La Costa,1,486,494,980,edad 0
06420,La Costa,2,538,567,1105,edad 0
06420,La Costa,3,568,525,1093,edad 0
06420,La Costa,4,567,544,1111,edad 0
06420,La Costa,5,582,557,1139,edad 0
06420,La Costa,6,534,556,1090,edad 0
06420,La Costa,7,549,554,1103,edad 0
06420,La Costa,8,531,534,1065,edad 0
06420,La Costa,9,525,564,1089,edad 0
06420,La Costa,10,585,625,1210,edad 10
06420,La Costa,11,612,536,1148,edad 10
06420,La Costa,12,571,571,1142,edad 10
06420,La Costa,13,547,527,1074,edad 10
06420,La Costa,14,568,571,1139,edad 10
06420,La Costa,15,528,570,1098,edad 10
06420,La Costa,16,524,467,991,edad 10
06420,La Costa,17,501,486,987,edad 10
06420,La Costa,18,498,463,961,edad 10
06420,La Costa,19,489,431,920,edad 10
06420,La Costa,20,441,459,900,edad 20
06420,La Costa,21,416,356,772,edad 20
06420,La Costa,22,413,460,873,edad 20
06420,La Costa,23,398,415,813,edad 20
06420,La Costa,24,371,446,817,edad 20
06420,La Costa,25,370,462,832,edad 20
06420,La Costa,26,361,417,778,edad 20
06420,La Costa,27,341,388,729,edad 20
06420,La Costa,28,395,414,809,edad 20
06420,La Costa,29,372,403,775,edad 20
06420,La Costa,30,363,396,759,edad 30
06420,La Costa,31,363,389,752,edad 30
06420,La Costa,32,325,399,724,edad 30
06420,La Costa,33,378,369,747,edad 30
06420,La Costa,34,330,353,683,edad 30
06420,La Costa,35,348,350,698,edad 30
06420,La Costa,36,395,423,818,edad 30
06420,La Costa,37,359,403,762,edad 30
06420,La Costa,38,437,408,845,edad 30
06420,La Costa,39,339,387,726,edad 30
06420,La Costa,40,366,409,775,edad 40
06420,La Costa,41,373,396,769,edad 40
06420,La Costa,42,374,381,755,edad 40
06420,La Costa,43,401,403,804,edad 40
06420,La Costa,44,377,384,761,edad 40
06420,La Costa,45,358,383,741,edad 40
06420,La Costa,46,352,363,715,edad 40
06420,La Costa,47,364,361,725,edad 40
06420,La Costa,48,343,376,719,edad 40
06420,La Costa,49,316,336,652,edad 40
06420,La Costa,50,407,392,799,edad 50
06420,La Costa,51,344,345,689,edad 50
06420,La Costa,52,335,351,686,edad 50
06420,La Costa,53,349,319,668,edad 50
06420,La Costa,54,330,309,639,edad 50
06420,La Costa,55,301,310,611,edad 50
06420,La Costa,56,344,332,676,edad 50
06420,La Costa,57,294,295,589,edad 50
06420,La Costa,58,284,279,563,edad 50
06420,La Costa,59,256,238,494,edad 50
06420,La Costa,60,249,304,553,edad 60
06420,La Costa,61,246,295,541,edad 60
06420,La Costa,62,246,262,508,edad 60
06420,La Costa,63,258,275,533,edad 60
06420,La Costa,64,228,236,464,edad 60
06420,La Costa,65,232,303,535,edad 60
06420,La Costa,66,203,264,467,edad 60
06420,La Costa,67,254,250,504,edad 60
06420,La Costa,68,230,261,491,edad 60
06420,La Costa,69,249,241,490,edad 60
06420,La Costa,70,234,227,461,edad 70
06420,La Costa,71,235,234,469,edad 70
06420,La Costa,72,201,203,404,edad 70
06420,La Costa,73,169,182,351,edad 70
06420,La Costa,74,191,200,391,edad 70
06420,La Costa,75,186,193,379,edad 70
06420,La Costa,76,137,146,283,edad 70
06420,La Costa,77,149,129,278,edad 70
06420,La Costa,78,111,121,232,edad 70
06420,La Costa,79,110,95,205,edad 70
06420,La Costa,80,88,111,199,edad 80
06420,La Costa,81,64,65,129,edad 80
06420,La Costa,82,60,57,117,edad 80
06420,La Costa,83,32,68,100,edad 80
06420,La Costa,84,53,51,104,edad 80
06420,La Costa,85,38,39,77,edad 80
06420,La Costa,86,22,39,61,edad 80
06420,La Costa,87,14,41,55,edad 80
06420,La Costa,88,13,26,39,edad 80
06420,La Costa,89,9,15,24,edad 80
06420,La Costa,90,6,16,22,edad 90
06420,La Costa,91,11,17,28,edad 90
06420,La Costa,92,8,9,17,edad 90
06420,La Costa,93,3,6,9,edad 90
06420,La Costa,94,1,5,6,edad 90
06420,La Costa,95,3,6,9,edad 90
06420,La Costa,96,0,3,3,edad 90
06420,La Costa,97,1,2,3,edad 90
06420,La Costa,98,1,1,2,edad 90
06420,La Costa,99,1,0,1,edad 90
06441,La Plata,0,4845,4580,9425,edad 0
06441,La Plata,1,4225,4056,8281,edad 0
06441,La Plata,2,4499,4391,8890,edad 0
06441,La Plata,3,4460,4202,8662,edad 0
06441,La Plata,4,4508,4372,8880,edad 0
06441,La Plata,5,4709,4533,9242,edad 0
06441,La Plata,6,4653,4460,9113,edad 0
06441,La Plata,7,4363,4272,8635,edad 0
06441,La Plata,8,4465,4371,8836,edad 0
06441,La Plata,9,4520,4313,8833,edad 0
06441,La Plata,10,4575,4461,9036,edad 10
06441,La Plata,11,4562,4434,8996,edad 10
06441,La Plata,12,4515,4390,8905,edad 10
06441,La Plata,13,4486,4360,8846,edad 10
06441,La Plata,14,4641,4429,9070,edad 10
06441,La Plata,15,4340,4302,8642,edad 10
06441,La Plata,16,4367,4243,8610,edad 10
06441,La Plata,17,4300,4094,8394,edad 10
06441,La Plata,18,4562,4740,9302,edad 10
06441,La Plata,19,5367,5281,10648,edad 10
06441,La Plata,20,5796,5679,11475,edad 20
06441,La Plata,21,6133,5940,12073,edad 20
06441,La Plata,22,6197,5958,12155,edad 20
06441,La Plata,23,6018,5787,11805,edad 20
06441,La Plata,24,5886,5555,11441,edad 20
06441,La Plata,25,5745,5296,11041,edad 20
06441,La Plata,26,5228,5132,10360,edad 20
06441,La Plata,27,4945,4742,9687,edad 20
06441,La Plata,28,4957,4591,9548,edad 20
06441,La Plata,29,4470,4326,8796,edad 20
06441,La Plata,30,4643,4687,9330,edad 30
06441,La Plata,31,4255,4169,8424,edad 30
06441,La Plata,32,3958,4031,7989,edad 30
06441,La Plata,33,3853,3775,7628,edad 30
06441,La Plata,34,3618,3488,7106,edad 30
06441,La Plata,35,3703,3711,7414,edad 30
06441,La Plata,36,3593,3635,7228,edad 30
06441,La Plata,37,3512,3535,7047,edad 30
06441,La Plata,38,3537,3611,7148,edad 30
06441,La Plata,39,3319,3497,6816,edad 30
06441,La Plata,40,3446,3678,7124,edad 40
06441,La Plata,41,3314,3381,6695,edad 40
06441,La Plata,42,3417,3576,6993,edad 40
06441,La Plata,43,3237,3448,6685,edad 40
06441,La Plata,44,3032,3265,6297,edad 40
06441,La Plata,45,3212,3512,6724,edad 40
06441,La Plata,46,3016,3363,6379,edad 40
06441,La Plata,47,3076,3316,6392,edad 40
06441,La Plata,48,2955,3162,6117,edad 40
06441,La Plata,49,2782,3147,5929,edad 40
06441,La Plata,50,3076,3650,6726,edad 50
06441,La Plata,51,2858,3169,6027,edad 50
06441,La Plata,52,2945,3243,6188,edad 50
06441,La Plata,53,2741,3097,5838,edad 50
06441,La Plata,54,2646,3011,5657,edad 50
06441,La Plata,55,2589,3036,5625,edad 50
06441,La Plata,56,2584,3088,5672,edad 50
06441,La Plata,57,2386,2651,5037,edad 50
06441,La Plata,58,2263,2641,4904,edad 50
06441,La Plata,59,2024,2417,4441,edad 50
06441,La Plata,60,2170,2700,4870,edad 60
06441,La Plata,61,1945,2323,4268,edad 60
06441,La Plata,62,2006,2368,4374,edad 60
06441,La Plata,63,1879,2279,4158,edad 60
06441,La Plata,64,1828,2128,3956,edad 60
06441,La Plata,65,1898,2411,4309,edad 60
06441,La Plata,66,1615,2098,3713,edad 60
06441,La Plata,67,1685,2138,3823,edad 60
06441,La Plata,68,1611,2190,3801,edad 60
06441,La Plata,69,1581,2038,3619,edad 60
06441,La Plata,70,1721,2510,4231,edad 70
06441,La Plata,71,1534,2230,3764,edad 70
06441,La Plata,72,1503,2208,3711,edad 70
06441,La Plata,73,1367,2087,3454,edad 70
06441,La Plata,74,1323,2133,3456,edad 70
06441,La Plata,75,1296,2018,3314,edad 70
06441,La Plata,76,1142,1909,3051,edad 70
06441,La Plata,77,1046,1678,2724,edad 70
06441,La Plata,78,990,1687,2677,edad 70
06441,La Plata,79,864,1606,2470,edad 70
06441,La Plata,80,765,1518,2283,edad 80
06441,La Plata,81,662,1252,1914,edad 80
06441,La Plata,82,588,1189,1777,edad 80
06441,La Plata,83,471,984,1455,edad 80
06441,La Plata,84,424,884,1308,edad 80
06441,La Plata,85,349,813,1162,edad 80
06441,La Plata,86,284,776,1060,edad 80
06441,La Plata,87,274,713,987,edad 80
06441,La Plata,88,223,583,806,edad 80
06441,La Plata,89,143,474,617,edad 80
06441,La Plata,90,134,413,547,edad 90
06441,La Plata,91,89,300,389,edad 90
06441,La Plata,92,80,238,318,edad 90
06441,La Plata,93,59,156,215,edad 90
06441,La Plata,94,28,167,195,edad 90
06441,La Plata,95,28,103,131,edad 90
06441,La Plata,96,16,63,79,edad 90
06441,La Plata,97,14,51,65,edad 90
06441,La Plata,98,11,38,49,edad 90
06441,La Plata,99,8,21,29,edad 90
06448,Laprida,0,87,115,202,edad 0
06448,Laprida,1,81,80,161,edad 0
06448,Laprida,2,99,94,193,edad 0
06448,Laprida,3,105,108,213,edad 0
06448,Laprida,4,97,92,189,edad 0
06448,Laprida,5,99,108,207,edad 0
06448,Laprida,6,88,90,178,edad 0
06448,Laprida,7,87,80,167,edad 0
06448,Laprida,8,105,97,202,edad 0
06448,Laprida,9,106,97,203,edad 0
06448,Laprida,10,94,89,183,edad 10
06448,Laprida,11,88,84,172,edad 10
06448,Laprida,12,78,70,148,edad 10
06448,Laprida,13,68,81,149,edad 10
06448,Laprida,14,83,90,173,edad 10
06448,Laprida,15,71,97,168,edad 10
06448,Laprida,16,90,92,182,edad 10
06448,Laprida,17,82,82,164,edad 10
06448,Laprida,18,78,88,166,edad 10
06448,Laprida,19,73,75,148,edad 10
06448,Laprida,20,79,67,146,edad 20
06448,Laprida,21,60,55,115,edad 20
06448,Laprida,22,81,64,145,edad 20
06448,Laprida,23,79,72,151,edad 20
06448,Laprida,24,72,67,139,edad 20
06448,Laprida,25,45,65,110,edad 20
06448,Laprida,26,48,56,104,edad 20
06448,Laprida,27,71,60,131,edad 20
06448,Laprida,28,62,60,122,edad 20
06448,Laprida,29,69,57,126,edad 20
06448,Laprida,30,58,43,101,edad 30
06448,Laprida,31,53,69,122,edad 30
06448,Laprida,32,51,65,116,edad 30
06448,Laprida,33,52,64,116,edad 30
06448,Laprida,34,46,56,102,edad 30
06448,Laprida,35,64,65,129,edad 30
06448,Laprida,36,56,63,119,edad 30
06448,Laprida,37,73,60,133,edad 30
06448,Laprida,38,47,65,112,edad 30
06448,Laprida,39,50,53,103,edad 30
06448,Laprida,40,80,63,143,edad 40
06448,Laprida,41,53,48,101,edad 40
06448,Laprida,42,63,66,129,edad 40
06448,Laprida,43,54,54,108,edad 40
06448,Laprida,44,47,46,93,edad 40
06448,Laprida,45,56,43,99,edad 40
06448,Laprida,46,60,48,108,edad 40
06448,Laprida,47,57,43,100,edad 40
06448,Laprida,48,54,53,107,edad 40
06448,Laprida,49,52,50,102,edad 40
06448,Laprida,50,48,60,108,edad 50
06448,Laprida,51,40,46,86,edad 50
06448,Laprida,52,47,61,108,edad 50
06448,Laprida,53,52,39,91,edad 50
06448,Laprida,54,41,55,96,edad 50
06448,Laprida,55,38,61,99,edad 50
06448,Laprida,56,63,61,124,edad 50
06448,Laprida,57,54,45,99,edad 50
06448,Laprida,58,51,49,100,edad 50
06448,Laprida,59,43,40,83,edad 50
06448,Laprida,60,42,56,98,edad 60
06448,Laprida,61,35,38,73,edad 60
06448,Laprida,62,39,43,82,edad 60
06448,Laprida,63,43,34,77,edad 60
06448,Laprida,64,27,44,71,edad 60
06448,Laprida,65,38,52,90,edad 60
06448,Laprida,66,34,34,68,edad 60
06448,Laprida,67,37,36,73,edad 60
06448,Laprida,68,32,41,73,edad 60
06448,Laprida,69,35,39,74,edad 60
06448,Laprida,70,31,32,63,edad 70
06448,Laprida,71,26,41,67,edad 70
06448,Laprida,72,25,41,66,edad 70
06448,Laprida,73,31,30,61,edad 70
06448,Laprida,74,27,33,60,edad 70
06448,Laprida,75,24,38,62,edad 70
06448,Laprida,76,26,21,47,edad 70
06448,Laprida,77,20,31,51,edad 70
06448,Laprida,78,10,34,44,edad 70
06448,Laprida,79,16,25,41,edad 70
06448,Laprida,80,12,19,31,edad 80
06448,Laprida,81,8,15,23,edad 80
06448,Laprida,82,10,20,30,edad 80
06448,Laprida,83,9,23,32,edad 80
06448,Laprida,84,6,17,23,edad 80
06448,Laprida,85,6,10,16,edad 80
06448,Laprida,86,7,12,19,edad 80
06448,Laprida,87,4,11,15,edad 80
06448,Laprida,88,5,14,19,edad 80
06448,Laprida,89,0,7,7,edad 80
06448,Laprida,90,2,3,5,edad 90
06448,Laprida,91,0,5,5,edad 90
06448,Laprida,92,0,2,2,edad 90
06448,Laprida,93,2,4,6,edad 90
06448,Laprida,94,1,5,6,edad 90
06448,Laprida,95,2,2,4,edad 90
06448,Laprida,96,0,3,3,edad 90
06448,Laprida,97,1,1,2,edad 90
06455,Las Flores,0,193,184,377,edad 0
06455,Las Flores,1,167,166,333,edad 0
06455,Las Flores,2,167,189,356,edad 0
06455,Las Flores,3,184,174,358,edad 0
06455,Las Flores,4,172,202,374,edad 0
06455,Las Flores,5,174,201,375,edad 0
06455,Las Flores,6,189,196,385,edad 0
06455,Las Flores,7,189,169,358,edad 0
06455,Las Flores,8,187,190,377,edad 0
06455,Las Flores,9,207,194,401,edad 0
06455,Las Flores,10,234,186,420,edad 10
06455,Las Flores,11,216,197,413,edad 10
06455,Las Flores,12,199,191,390,edad 10
06455,Las Flores,13,175,189,364,edad 10
06455,Las Flores,14,197,167,364,edad 10
06455,Las Flores,15,185,174,359,edad 10
06455,Las Flores,16,188,174,362,edad 10
06455,Las Flores,17,194,171,365,edad 10
06455,Las Flores,18,202,163,365,edad 10
06455,Las Flores,19,185,171,356,edad 10
06455,Las Flores,20,195,176,371,edad 20
06455,Las Flores,21,197,180,377,edad 20
06455,Las Flores,22,213,167,380,edad 20
06455,Las Flores,23,193,163,356,edad 20
06455,Las Flores,24,142,159,301,edad 20
06455,Las Flores,25,151,137,288,edad 20
06455,Las Flores,26,138,164,302,edad 20
06455,Las Flores,27,152,148,300,edad 20
06455,Las Flores,28,148,138,286,edad 20
06455,Las Flores,29,135,111,246,edad 20
06455,Las Flores,30,142,168,310,edad 30
06455,Las Flores,31,111,144,255,edad 30
06455,Las Flores,32,125,128,253,edad 30
06455,Las Flores,33,132,138,270,edad 30
06455,Las Flores,34,126,120,246,edad 30
06455,Las Flores,35,138,145,283,edad 30
06455,Las Flores,36,124,176,300,edad 30
06455,Las Flores,37,156,148,304,edad 30
06455,Las Flores,38,149,145,294,edad 30
06455,Las Flores,39,140,157,297,edad 30
06455,Las Flores,40,161,165,326,edad 40
06455,Las Flores,41,145,159,304,edad 40
06455,Las Flores,42,121,154,275,edad 40
06455,Las Flores,43,125,150,275,edad 40
06455,Las Flores,44,134,127,261,edad 40
06455,Las Flores,45,126,153,279,edad 40
06455,Las Flores,46,148,140,288,edad 40
06455,Las Flores,47,134,150,284,edad 40
06455,Las Flores,48,125,143,268,edad 40
06455,Las Flores,49,132,119,251,edad 40
06455,Las Flores,50,139,155,294,edad 50
06455,Las Flores,51,149,132,281,edad 50
06455,Las Flores,52,121,135,256,edad 50
06455,Las Flores,53,145,144,289,edad 50
06455,Las Flores,54,150,138,288,edad 50
06455,Las Flores,55,142,138,280,edad 50
06455,Las Flores,56,139,161,300,edad 50
06455,Las Flores,57,97,119,216,edad 50
06455,Las Flores,58,122,121,243,edad 50
06455,Las Flores,59,105,124,229,edad 50
06455,Las Flores,60,102,107,209,edad 60
06455,Las Flores,61,107,100,207,edad 60
06455,Las Flores,62,100,123,223,edad 60
06455,Las Flores,63,89,128,217,edad 60
06455,Las Flores,64,103,98,201,edad 60
06455,Las Flores,65,97,80,177,edad 60
06455,Las Flores,66,86,116,202,edad 60
06455,Las Flores,67,93,92,185,edad 60
06455,Las Flores,68,84,85,169,edad 60
06455,Las Flores,69,81,91,172,edad 60
06455,Las Flores,70,85,114,199,edad 70
06455,Las Flores,71,81,96,177,edad 70
06455,Las Flores,72,83,123,206,edad 70
06455,Las Flores,73,80,125,205,edad 70
06455,Las Flores,74,73,110,183,edad 70
06455,Las Flores,75,75,98,173,edad 70
06455,Las Flores,76,71,89,160,edad 70
06455,Las Flores,77,59,101,160,edad 70
06455,Las Flores,78,66,106,172,edad 70
06455,Las Flores,79,49,81,130,edad 70
06455,Las Flores,80,56,79,135,edad 80
06455,Las Flores,81,43,62,105,edad 80
06455,Las Flores,82,28,73,101,edad 80
06455,Las Flores,83,40,55,95,edad 80
06455,Las Flores,84,25,47,72,edad 80
06455,Las Flores,85,26,47,73,edad 80
06455,Las Flores,86,21,40,61,edad 80
06455,Las Flores,87,17,30,47,edad 80
06455,Las Flores,88,14,36,50,edad 80
06455,Las Flores,89,5,19,24,edad 80
06455,Las Flores,90,14,19,33,edad 90
06455,Las Flores,91,9,8,17,edad 90
06455,Las Flores,92,4,11,15,edad 90
06455,Las Flores,93,2,10,12,edad 90
06455,Las Flores,94,1,7,8,edad 90
06455,Las Flores,95,3,5,8,edad 90
06455,Las Flores,96,0,2,2,edad 90
06455,Las Flores,97,1,3,4,edad 90
06455,Las Flores,98,0,1,1,edad 90
06455,Las Flores,99,0,1,1,edad 90
06462,Leandro N. Alem,0,142,111,253,edad 0
06462,Leandro N. Alem,1,142,140,282,edad 0
06462,Leandro N. Alem,2,148,156,304,edad 0
06462,Leandro N. Alem,3,141,148,289,edad 0
06462,Leandro N. Alem,4,151,147,298,edad 0
06462,Leandro N. Alem,5,172,142,314,edad 0
06462,Leandro N. Alem,6,150,144,294,edad 0
06462,Leandro N. Alem,7,159,153,312,edad 0
06462,Leandro N. Alem,8,143,130,273,edad 0
06462,Leandro N. Alem,9,161,155,316,edad 0
06462,Leandro N. Alem,10,167,156,323,edad 10
06462,Leandro N. Alem,11,143,149,292,edad 10
06462,Leandro N. Alem,12,133,129,262,edad 10
06462,Leandro N. Alem,13,131,128,259,edad 10
06462,Leandro N. Alem,14,129,139,268,edad 10
06462,Leandro N. Alem,15,145,145,290,edad 10
06462,Leandro N. Alem,16,123,148,271,edad 10
06462,Leandro N. Alem,17,139,123,262,edad 10
06462,Leandro N. Alem,18,134,137,271,edad 10
06462,Leandro N. Alem,19,130,146,276,edad 10
06462,Leandro N. Alem,20,117,130,247,edad 20
06462,Leandro N. Alem,21,125,124,249,edad 20
06462,Leandro N. Alem,22,122,115,237,edad 20
06462,Leandro N. Alem,23,120,108,228,edad 20
06462,Leandro N. Alem,24,122,121,243,edad 20
06462,Leandro N. Alem,25,106,104,210,edad 20
06462,Leandro N. Alem,26,101,106,207,edad 20
06462,Leandro N. Alem,27,93,104,197,edad 20
06462,Leandro N. Alem,28,84,101,185,edad 20
06462,Leandro N. Alem,29,94,104,198,edad 20
06462,Leandro N. Alem,30,101,80,181,edad 30
06462,Leandro N. Alem,31,76,90,166,edad 30
06462,Leandro N. Alem,32,80,85,165,edad 30
06462,Leandro N. Alem,33,91,67,158,edad 30
06462,Leandro N. Alem,34,95,92,187,edad 30
06462,Leandro N. Alem,35,90,112,202,edad 30
06462,Leandro N. Alem,36,86,73,159,edad 30
06462,Leandro N. Alem,37,72,105,177,edad 30
06462,Leandro N. Alem,38,108,94,202,edad 30
06462,Leandro N. Alem,39,86,99,185,edad 30
06462,Leandro N. Alem,40,91,104,195,edad 40
06462,Leandro N. Alem,41,84,106,190,edad 40
06462,Leandro N. Alem,42,103,107,210,edad 40
06462,Leandro N. Alem,43,82,81,163,edad 40
06462,Leandro N. Alem,44,80,87,167,edad 40
06462,Leandro N. Alem,45,86,65,151,edad 40
06462,Leandro N. Alem,46,87,93,180,edad 40
06462,Leandro N. Alem,47,94,94,188,edad 40
06462,Leandro N. Alem,48,85,115,200,edad 40
06462,Leandro N. Alem,49,75,98,173,edad 40
06462,Leandro N. Alem,50,90,99,189,edad 50
06462,Leandro N. Alem,51,97,89,186,edad 50
06462,Leandro N. Alem,52,103,99,202,edad 50
06462,Leandro N. Alem,53,91,93,184,edad 50
06462,Leandro N. Alem,54,85,74,159,edad 50
06462,Leandro N. Alem,55,68,71,139,edad 50
06462,Leandro N. Alem,56,74,77,151,edad 50
06462,Leandro N. Alem,57,94,73,167,edad 50
06462,Leandro N. Alem,58,86,102,188,edad 50
06462,Leandro N. Alem,59,77,73,150,edad 50
06462,Leandro N. Alem,60,83,83,166,edad 60
06462,Leandro N. Alem,61,92,65,157,edad 60
06462,Leandro N. Alem,62,68,75,143,edad 60
06462,Leandro N. Alem,63,72,79,151,edad 60
06462,Leandro N. Alem,64,71,107,178,edad 60
06462,Leandro N. Alem,65,70,92,162,edad 60
06462,Leandro N. Alem,66,55,78,133,edad 60
06462,Leandro N. Alem,67,78,67,145,edad 60
06462,Leandro N. Alem,68,68,83,151,edad 60
06462,Leandro N. Alem,69,58,77,135,edad 60
06462,Leandro N. Alem,70,64,75,139,edad 70
06462,Leandro N. Alem,71,68,84,152,edad 70
06462,Leandro N. Alem,72,59,62,121,edad 70
06462,Leandro N. Alem,73,66,64,130,edad 70
06462,Leandro N. Alem,74,52,58,110,edad 70
06462,Leandro N. Alem,75,39,66,105,edad 70
06462,Leandro N. Alem,76,49,51,100,edad 70
06462,Leandro N. Alem,77,40,62,102,edad 70
06462,Leandro N. Alem,78,38,54,92,edad 70
06462,Leandro N. Alem,79,30,31,61,edad 70
06462,Leandro N. Alem,80,34,43,77,edad 80
06462,Leandro N. Alem,81,26,36,62,edad 80
06462,Leandro N. Alem,82,21,38,59,edad 80
06462,Leandro N. Alem,83,23,35,58,edad 80
06462,Leandro N. Alem,84,11,30,41,edad 80
06462,Leandro N. Alem,85,11,31,42,edad 80
06462,Leandro N. Alem,86,7,20,27,edad 80
06462,Leandro N. Alem,87,7,26,33,edad 80
06462,Leandro N. Alem,88,9,30,39,edad 80
06462,Leandro N. Alem,89,5,9,14,edad 80
06462,Leandro N. Alem,90,3,11,14,edad 90
06462,Leandro N. Alem,91,1,5,6,edad 90
06462,Leandro N. Alem,92,1,5,6,edad 90
06462,Leandro N. Alem,93,5,6,11,edad 90
06462,Leandro N. Alem,94,1,3,4,edad 90
06462,Leandro N. Alem,95,0,2,2,edad 90
06462,Leandro N. Alem,97,0,2,2,edad 90
06462,Leandro N. Alem,99,0,2,2,edad 90
06469,Lincoln,0,313,312,625,edad 0
06469,Lincoln,1,302,341,643,edad 0
06469,Lincoln,2,335,342,677,edad 0
06469,Lincoln,3,356,313,669,edad 0
06469,Lincoln,4,353,349,702,edad 0
06469,Lincoln,5,324,315,639,edad 0
06469,Lincoln,6,351,351,702,edad 0
06469,Lincoln,7,351,305,656,edad 0
06469,Lincoln,8,375,324,699,edad 0
06469,Lincoln,9,384,313,697,edad 0
06469,Lincoln,10,383,385,768,edad 10
06469,Lincoln,11,382,330,712,edad 10
06469,Lincoln,12,346,334,680,edad 10
06469,Lincoln,13,326,323,649,edad 10
06469,Lincoln,14,335,324,659,edad 10
06469,Lincoln,15,382,330,712,edad 10
06469,Lincoln,16,364,346,710,edad 10
06469,Lincoln,17,351,320,671,edad 10
06469,Lincoln,18,320,314,634,edad 10
06469,Lincoln,19,304,296,600,edad 10
06469,Lincoln,20,310,279,589,edad 20
06469,Lincoln,21,328,307,635,edad 20
06469,Lincoln,22,288,305,593,edad 20
06469,Lincoln,23,270,277,547,edad 20
06469,Lincoln,24,281,273,554,edad 20
06469,Lincoln,25,282,292,574,edad 20
06469,Lincoln,26,277,254,531,edad 20
06469,Lincoln,27,250,255,505,edad 20
06469,Lincoln,28,254,286,540,edad 20
06469,Lincoln,29,250,263,513,edad 20
06469,Lincoln,30,253,258,511,edad 30
06469,Lincoln,31,227,277,504,edad 30
06469,Lincoln,32,251,268,519,edad 30
06469,Lincoln,33,270,251,521,edad 30
06469,Lincoln,34,254,241,495,edad 30
06469,Lincoln,35,235,268,503,edad 30
06469,Lincoln,36,254,250,504,edad 30
06469,Lincoln,37,229,239,468,edad 30
06469,Lincoln,38,269,281,550,edad 30
06469,Lincoln,39,234,247,481,edad 30
06469,Lincoln,40,280,264,544,edad 40
06469,Lincoln,41,218,263,481,edad 40
06469,Lincoln,42,242,238,480,edad 40
06469,Lincoln,43,223,225,448,edad 40
06469,Lincoln,44,209,234,443,edad 40
06469,Lincoln,45,251,277,528,edad 40
06469,Lincoln,46,237,215,452,edad 40
06469,Lincoln,47,246,231,477,edad 40
06469,Lincoln,48,260,236,496,edad 40
06469,Lincoln,49,232,219,451,edad 40
06469,Lincoln,50,211,237,448,edad 50
06469,Lincoln,51,260,259,519,edad 50
06469,Lincoln,52,253,238,491,edad 50
06469,Lincoln,53,220,255,475,edad 50
06469,Lincoln,54,231,229,460,edad 50
06469,Lincoln,55,224,225,449,edad 50
06469,Lincoln,56,245,237,482,edad 50
06469,Lincoln,57,221,201,422,edad 50
06469,Lincoln,58,191,219,410,edad 50
06469,Lincoln,59,185,199,384,edad 50
06469,Lincoln,60,208,194,402,edad 60
06469,Lincoln,61,170,196,366,edad 60
06469,Lincoln,62,195,210,405,edad 60
06469,Lincoln,63,192,208,400,edad 60
06469,Lincoln,64,184,169,353,edad 60
06469,Lincoln,65,183,168,351,edad 60
06469,Lincoln,66,170,156,326,edad 60
06469,Lincoln,67,149,158,307,edad 60
06469,Lincoln,68,126,193,319,edad 60
06469,Lincoln,69,130,155,285,edad 60
06469,Lincoln,70,163,211,374,edad 70
06469,Lincoln,71,115,159,274,edad 70
06469,Lincoln,72,121,172,293,edad 70
06469,Lincoln,73,112,165,277,edad 70
06469,Lincoln,74,123,142,265,edad 70
06469,Lincoln,75,112,166,278,edad 70
06469,Lincoln,76,108,147,255,edad 70
06469,Lincoln,77,91,146,237,edad 70
06469,Lincoln,78,98,166,264,edad 70
06469,Lincoln,79,82,102,184,edad 70
06469,Lincoln,80,73,146,219,edad 80
06469,Lincoln,81,57,95,152,edad 80
06469,Lincoln,82,61,116,177,edad 80
06469,Lincoln,83,49,106,155,edad 80
06469,Lincoln,84,40,70,110,edad 80
06469,Lincoln,85,34,80,114,edad 80
06469,Lincoln,86,30,75,105,edad 80
06469,Lincoln,87,34,59,93,edad 80
06469,Lincoln,88,22,43,65,edad 80
06469,Lincoln,89,28,43,71,edad 80
06469,Lincoln,90,13,29,42,edad 90
06469,Lincoln,91,11,25,36,edad 90
06469,Lincoln,92,12,18,30,edad 90
06469,Lincoln,93,2,22,24,edad 90
06469,Lincoln,94,0,14,14,edad 90
06469,Lincoln,95,1,5,6,edad 90
06469,Lincoln,96,1,4,5,edad 90
06469,Lincoln,97,0,4,4,edad 90
06469,Lincoln,98,4,2,6,edad 90
06469,Lincoln,99,0,1,1,edad 90
06476,Lobería,0,146,153,299,edad 0
06476,Lobería,1,117,159,276,edad 0
06476,Lobería,2,131,121,252,edad 0
06476,Lobería,3,175,134,309,edad 0
06476,Lobería,4,129,146,275,edad 0
06476,Lobería,5,140,142,282,edad 0
06476,Lobería,6,157,145,302,edad 0
06476,Lobería,7,144,154,298,edad 0
06476,Lobería,8,151,134,285,edad 0
06476,Lobería,9,160,163,323,edad 0
06476,Lobería,10,177,155,332,edad 10
06476,Lobería,11,159,156,315,edad 10
06476,Lobería,12,174,145,319,edad 10
06476,Lobería,13,148,149,297,edad 10
06476,Lobería,14,149,143,292,edad 10
06476,Lobería,15,162,143,305,edad 10
06476,Lobería,16,150,145,295,edad 10
06476,Lobería,17,132,138,270,edad 10
06476,Lobería,18,112,106,218,edad 10
06476,Lobería,19,146,112,258,edad 10
06476,Lobería,20,144,119,263,edad 20
06476,Lobería,21,106,137,243,edad 20
06476,Lobería,22,118,89,207,edad 20
06476,Lobería,23,108,109,217,edad 20
06476,Lobería,24,88,101,189,edad 20
06476,Lobería,25,98,101,199,edad 20
06476,Lobería,26,76,89,165,edad 20
06476,Lobería,27,97,100,197,edad 20
06476,Lobería,28,100,107,207,edad 20
06476,Lobería,29,98,126,224,edad 20
06476,Lobería,30,110,100,210,edad 30
06476,Lobería,31,101,105,206,edad 30
06476,Lobería,32,106,138,244,edad 30
06476,Lobería,33,107,96,203,edad 30
06476,Lobería,34,92,113,205,edad 30
06476,Lobería,35,99,114,213,edad 30
06476,Lobería,36,124,120,244,edad 30
06476,Lobería,37,129,98,227,edad 30
06476,Lobería,38,117,119,236,edad 30
06476,Lobería,39,102,119,221,edad 30
06476,Lobería,40,117,126,243,edad 40
06476,Lobería,41,97,97,194,edad 40
06476,Lobería,42,108,92,200,edad 40
06476,Lobería,43,105,102,207,edad 40
06476,Lobería,44,103,106,209,edad 40
06476,Lobería,45,126,93,219,edad 40
06476,Lobería,46,91,98,189,edad 40
06476,Lobería,47,104,88,192,edad 40
06476,Lobería,48,97,86,183,edad 40
06476,Lobería,49,98,99,197,edad 40
06476,Lobería,50,102,90,192,edad 50
06476,Lobería,51,84,72,156,edad 50
06476,Lobería,52,107,81,188,edad 50
06476,Lobería,53,84,94,178,edad 50
06476,Lobería,54,92,73,165,edad 50
06476,Lobería,55,94,90,184,edad 50
06476,Lobería,56,100,78,178,edad 50
06476,Lobería,57,82,69,151,edad 50
06476,Lobería,58,90,73,163,edad 50
06476,Lobería,59,78,73,151,edad 50
06476,Lobería,60,80,70,150,edad 60
06476,Lobería,61,74,74,148,edad 60
06476,Lobería,62,77,73,150,edad 60
06476,Lobería,63,74,69,143,edad 60
06476,Lobería,64,83,73,156,edad 60
06476,Lobería,65,88,80,168,edad 60
06476,Lobería,66,54,87,141,edad 60
06476,Lobería,67,71,82,153,edad 60
06476,Lobería,68,61,80,141,edad 60
06476,Lobería,69,72,63,135,edad 60
06476,Lobería,70,86,71,157,edad 70
06476,Lobería,71,73,79,152,edad 70
06476,Lobería,72,56,80,136,edad 70
06476,Lobería,73,59,72,131,edad 70
06476,Lobería,74,49,87,136,edad 70
06476,Lobería,75,51,65,116,edad 70
06476,Lobería,76,47,67,114,edad 70
06476,Lobería,77,58,42,100,edad 70
06476,Lobería,78,42,50,92,edad 70
06476,Lobería,79,37,33,70,edad 70
06476,Lobería,80,28,44,72,edad 80
06476,Lobería,81,31,38,69,edad 80
06476,Lobería,82,18,27,45,edad 80
06476,Lobería,83,19,18,37,edad 80
06476,Lobería,84,17,27,44,edad 80
06476,Lobería,85,9,25,34,edad 80
06476,Lobería,86,12,24,36,edad 80
06476,Lobería,87,6,29,35,edad 80
06476,Lobería,88,12,16,28,edad 80
06476,Lobería,89,4,14,18,edad 80
06476,Lobería,90,4,9,13,edad 90
06476,Lobería,91,0,7,7,edad 90
06476,Lobería,92,2,6,8,edad 90
06476,Lobería,93,0,4,4,edad 90
06476,Lobería,94,1,0,1,edad 90
06476,Lobería,95,0,4,4,edad 90
06476,Lobería,96,0,1,1,edad 90
06476,Lobería,97,0,1,1,edad 90
06476,Lobería,99,0,1,1,edad 90
06483,Lobos,0,271,304,575,edad 0
06483,Lobos,1,268,275,543,edad 0
06483,Lobos,2,280,290,570,edad 0
06483,Lobos,3,287,255,542,edad 0
06483,Lobos,4,288,274,562,edad 0
06483,Lobos,5,268,251,519,edad 0
06483,Lobos,6,274,295,569,edad 0
06483,Lobos,7,262,251,513,edad 0
06483,Lobos,8,276,278,554,edad 0
06483,Lobos,9,270,267,537,edad 0
06483,Lobos,10,307,286,593,edad 10
06483,Lobos,11,297,296,593,edad 10
06483,Lobos,12,265,281,546,edad 10
06483,Lobos,13,305,290,595,edad 10
06483,Lobos,14,300,273,573,edad 10
06483,Lobos,15,276,293,569,edad 10
06483,Lobos,16,264,267,531,edad 10
06483,Lobos,17,279,278,557,edad 10
06483,Lobos,18,261,248,509,edad 10
06483,Lobos,19,282,251,533,edad 10
06483,Lobos,20,285,246,531,edad 20
06483,Lobos,21,281,315,596,edad 20
06483,Lobos,22,255,264,519,edad 20
06483,Lobos,23,253,250,503,edad 20
06483,Lobos,24,238,260,498,edad 20
06483,Lobos,25,257,231,488,edad 20
06483,Lobos,26,223,230,453,edad 20
06483,Lobos,27,220,218,438,edad 20
06483,Lobos,28,239,212,451,edad 20
06483,Lobos,29,198,206,404,edad 20
06483,Lobos,30,234,236,470,edad 30
06483,Lobos,31,201,197,398,edad 30
06483,Lobos,32,217,202,419,edad 30
06483,Lobos,33,178,177,355,edad 30
06483,Lobos,34,194,195,389,edad 30
06483,Lobos,35,190,187,377,edad 30
06483,Lobos,36,184,225,409,edad 30
06483,Lobos,37,184,203,387,edad 30
06483,Lobos,38,183,229,412,edad 30
06483,Lobos,39,200,205,405,edad 30
06483,Lobos,40,219,194,413,edad 40
06483,Lobos,41,188,201,389,edad 40
06483,Lobos,42,210,206,416,edad 40
06483,Lobos,43,185,205,390,edad 40
06483,Lobos,44,167,190,357,edad 40
06483,Lobos,45,180,188,368,edad 40
06483,Lobos,46,188,217,405,edad 40
06483,Lobos,47,166,180,346,edad 40
06483,Lobos,48,162,184,346,edad 40
06483,Lobos,49,202,186,388,edad 40
06483,Lobos,50,211,211,422,edad 50
06483,Lobos,51,189,196,385,edad 50
06483,Lobos,52,205,172,377,edad 50
06483,Lobos,53,170,188,358,edad 50
06483,Lobos,54,175,178,353,edad 50
06483,Lobos,55,172,176,348,edad 50
06483,Lobos,56,196,172,368,edad 50
06483,Lobos,57,172,191,363,edad 50
06483,Lobos,58,137,155,292,edad 50
06483,Lobos,59,150,145,295,edad 50
06483,Lobos,60,144,178,322,edad 60
06483,Lobos,61,147,155,302,edad 60
06483,Lobos,62,136,145,281,edad 60
06483,Lobos,63,122,159,281,edad 60
06483,Lobos,64,112,117,229,edad 60
06483,Lobos,65,121,153,274,edad 60
06483,Lobos,66,114,138,252,edad 60
06483,Lobos,67,99,149,248,edad 60
06483,Lobos,68,113,142,255,edad 60
06483,Lobos,69,114,141,255,edad 60
06483,Lobos,70,114,134,248,edad 70
06483,Lobos,71,90,118,208,edad 70
06483,Lobos,72,102,148,250,edad 70
06483,Lobos,73,117,137,254,edad 70
06483,Lobos,74,87,126,213,edad 70
06483,Lobos,75,90,125,215,edad 70
06483,Lobos,76,70,107,177,edad 70
06483,Lobos,77,64,104,168,edad 70
06483,Lobos,78,59,95,154,edad 70
06483,Lobos,79,55,106,161,edad 70
06483,Lobos,80,49,87,136,edad 80
06483,Lobos,81,53,80,133,edad 80
06483,Lobos,82,37,69,106,edad 80
06483,Lobos,83,31,74,105,edad 80
06483,Lobos,84,26,55,81,edad 80
06483,Lobos,85,21,62,83,edad 80
06483,Lobos,86,26,46,72,edad 80
06483,Lobos,87,17,50,67,edad 80
06483,Lobos,88,20,47,67,edad 80
06483,Lobos,89,10,31,41,edad 80
06483,Lobos,90,13,37,50,edad 90
06483,Lobos,91,6,21,27,edad 90
06483,Lobos,92,6,14,20,edad 90
06483,Lobos,93,1,16,17,edad 90
06483,Lobos,94,1,5,6,edad 90
06483,Lobos,95,3,2,5,edad 90
06483,Lobos,96,1,5,6,edad 90
06483,Lobos,97,0,3,3,edad 90
06483,Lobos,98,0,3,3,edad 90
06483,Lobos,99,1,1,2,edad 90
06497,Luján,0,804,742,1546,edad 0
06497,Luján,1,783,723,1506,edad 0
06497,Luján,2,788,781,1569,edad 0
06497,Luján,3,792,810,1602,edad 0
06497,Luján,4,816,804,1620,edad 0
06497,Luján,5,794,798,1592,edad 0
06497,Luján,6,791,743,1534,edad 0
06497,Luján,7,823,831,1654,edad 0
06497,Luján,8,799,834,1633,edad 0
06497,Luján,9,834,791,1625,edad 0
06497,Luján,10,895,853,1748,edad 10
06497,Luján,11,863,875,1738,edad 10
06497,Luján,12,806,776,1582,edad 10
06497,Luján,13,827,784,1611,edad 10
06497,Luján,14,825,778,1603,edad 10
06497,Luján,15,809,795,1604,edad 10
06497,Luján,16,807,737,1544,edad 10
06497,Luján,17,743,768,1511,edad 10
06497,Luján,18,828,729,1557,edad 10
06497,Luján,19,809,804,1613,edad 10
06497,Luján,20,827,722,1549,edad 20
06497,Luján,21,855,822,1677,edad 20
06497,Luján,22,869,792,1661,edad 20
06497,Luján,23,832,854,1686,edad 20
06497,Luján,24,833,724,1557,edad 20
06497,Luján,25,700,721,1421,edad 20
06497,Luján,26,667,673,1340,edad 20
06497,Luján,27,701,672,1373,edad 20
06497,Luján,28,717,710,1427,edad 20
06497,Luján,29,646,649,1295,edad 20
06497,Luján,30,696,765,1461,edad 30
06497,Luján,31,647,646,1293,edad 30
06497,Luján,32,671,614,1285,edad 30
06497,Luján,33,629,680,1309,edad 30
06497,Luján,34,634,567,1201,edad 30
06497,Luján,35,594,584,1178,edad 30
06497,Luján,36,569,594,1163,edad 30
06497,Luján,37,610,594,1204,edad 30
06497,Luján,38,641,645,1286,edad 30
06497,Luján,39,574,600,1174,edad 30
06497,Luján,40,606,571,1177,edad 40
06497,Luján,41,584,555,1139,edad 40
06497,Luján,42,611,595,1206,edad 40
06497,Luján,43,578,564,1142,edad 40
06497,Luján,44,531,502,1033,edad 40
06497,Luján,45,500,553,1053,edad 40
06497,Luján,46,504,483,987,edad 40
06497,Luján,47,496,519,1015,edad 40
06497,Luján,48,498,569,1067,edad 40
06497,Luján,49,476,523,999,edad 40
06497,Luján,50,524,555,1079,edad 50
06497,Luján,51,527,501,1028,edad 50
06497,Luján,52,480,499,979,edad 50
06497,Luján,53,471,472,943,edad 50
06497,Luján,54,467,485,952,edad 50
06497,Luján,55,480,443,923,edad 50
06497,Luján,56,441,493,934,edad 50
06497,Luján,57,411,433,844,edad 50
06497,Luján,58,411,449,860,edad 50
06497,Luján,59,366,387,753,edad 50
06497,Luján,60,405,430,835,edad 60
06497,Luján,61,380,377,757,edad 60
06497,Luján,62,356,378,734,edad 60
06497,Luján,63,341,376,717,edad 60
06497,Luján,64,356,364,720,edad 60
06497,Luján,65,354,361,715,edad 60
06497,Luján,66,286,359,645,edad 60
06497,Luján,67,310,317,627,edad 60
06497,Luján,68,293,364,657,edad 60
06497,Luján,69,268,346,614,edad 60
06497,Luján,70,286,351,637,edad 70
06497,Luján,71,272,362,634,edad 70
06497,Luján,72,272,347,619,edad 70
06497,Luján,73,227,311,538,edad 70
06497,Luján,74,218,305,523,edad 70
06497,Luján,75,239,277,516,edad 70
06497,Luján,76,185,279,464,edad 70
06497,Luján,77,155,265,420,edad 70
06497,Luján,78,142,269,411,edad 70
06497,Luján,79,125,213,338,edad 70
06497,Luján,80,117,220,337,edad 80
06497,Luján,81,120,171,291,edad 80
06497,Luján,82,82,154,236,edad 80
06497,Luján,83,91,151,242,edad 80
06497,Luján,84,56,124,180,edad 80
06497,Luján,85,43,128,171,edad 80
06497,Luján,86,59,106,165,edad 80
06497,Luján,87,36,80,116,edad 80
06497,Luján,88,29,59,88,edad 80
06497,Luján,89,21,50,71,edad 80
06497,Luján,90,21,71,92,edad 90
06497,Luján,91,26,34,60,edad 90
06497,Luján,92,11,33,44,edad 90
06497,Luján,93,14,29,43,edad 90
06497,Luján,94,6,24,30,edad 90
06497,Luján,95,2,19,21,edad 90
06497,Luján,96,3,10,13,edad 90
06497,Luján,97,5,4,9,edad 90
06497,Luján,98,2,6,8,edad 90
06497,Luján,99,0,3,3,edad 90
06505,Magdalena,0,163,132,295,edad 0
06505,Magdalena,1,128,120,248,edad 0
06505,Magdalena,2,121,116,237,edad 0
06505,Magdalena,3,141,127,268,edad 0
06505,Magdalena,4,139,149,288,edad 0
06505,Magdalena,5,158,143,301,edad 0
06505,Magdalena,6,138,144,282,edad 0
06505,Magdalena,7,140,138,278,edad 0
06505,Magdalena,8,133,128,261,edad 0
06505,Magdalena,9,162,157,319,edad 0
06505,Magdalena,10,143,134,277,edad 10
06505,Magdalena,11,150,151,301,edad 10
06505,Magdalena,12,144,139,283,edad 10
06505,Magdalena,13,134,124,258,edad 10
06505,Magdalena,14,134,120,254,edad 10
06505,Magdalena,15,133,132,265,edad 10
06505,Magdalena,16,128,135,263,edad 10
06505,Magdalena,17,127,89,216,edad 10
06505,Magdalena,18,141,131,272,edad 10
06505,Magdalena,19,202,120,322,edad 10
06505,Magdalena,20,256,133,389,edad 20
06505,Magdalena,21,279,122,401,edad 20
06505,Magdalena,22,231,133,364,edad 20
06505,Magdalena,23,267,111,378,edad 20
06505,Magdalena,24,228,126,354,edad 20
06505,Magdalena,25,232,124,356,edad 20
06505,Magdalena,26,223,102,325,edad 20
06505,Magdalena,27,202,94,296,edad 20
06505,Magdalena,28,168,99,267,edad 20
06505,Magdalena,29,157,92,249,edad 20
06505,Magdalena,30,157,122,279,edad 30
06505,Magdalena,31,161,86,247,edad 30
06505,Magdalena,32,136,109,245,edad 30
06505,Magdalena,33,114,78,192,edad 30
06505,Magdalena,34,106,83,189,edad 30
06505,Magdalena,35,133,96,229,edad 30
06505,Magdalena,36,123,68,191,edad 30
06505,Magdalena,37,105,86,191,edad 30
06505,Magdalena,38,104,91,195,edad 30
06505,Magdalena,39,122,68,190,edad 30
06505,Magdalena,40,104,77,181,edad 40
06505,Magdalena,41,110,85,195,edad 40
06505,Magdalena,42,103,99,202,edad 40
06505,Magdalena,43,98,87,185,edad 40
06505,Magdalena,44,86,79,165,edad 40
06505,Magdalena,45,83,68,151,edad 40
06505,Magdalena,46,90,84,174,edad 40
06505,Magdalena,47,97,82,179,edad 40
06505,Magdalena,48,89,84,173,edad 40
06505,Magdalena,49,81,80,161,edad 40
06505,Magdalena,50,97,83,180,edad 50
06505,Magdalena,51,78,67,145,edad 50
06505,Magdalena,52,80,67,147,edad 50
06505,Magdalena,53,84,78,162,edad 50
06505,Magdalena,54,76,67,143,edad 50
06505,Magdalena,55,79,60,139,edad 50
06505,Magdalena,56,82,67,149,edad 50
06505,Magdalena,57,71,78,149,edad 50
06505,Magdalena,58,65,49,114,edad 50
06505,Magdalena,59,63,50,113,edad 50
06505,Magdalena,60,59,64,123,edad 60
06505,Magdalena,61,51,43,94,edad 60
06505,Magdalena,62,70,60,130,edad 60
06505,Magdalena,63,54,60,114,edad 60
06505,Magdalena,64,68,51,119,edad 60
06505,Magdalena,65,48,54,102,edad 60
06505,Magdalena,66,49,48,97,edad 60
06505,Magdalena,67,59,53,112,edad 60
06505,Magdalena,68,50,60,110,edad 60
06505,Magdalena,69,54,65,119,edad 60
06505,Magdalena,70,48,72,120,edad 70
06505,Magdalena,71,51,44,95,edad 70
06505,Magdalena,72,51,67,118,edad 70
06505,Magdalena,73,48,54,102,edad 70
06505,Magdalena,74,34,47,81,edad 70
06505,Magdalena,75,38,53,91,edad 70
06505,Magdalena,76,28,52,80,edad 70
06505,Magdalena,77,22,43,65,edad 70
06505,Magdalena,78,29,42,71,edad 70
06505,Magdalena,79,17,41,58,edad 70
06505,Magdalena,80,22,34,56,edad 80
06505,Magdalena,81,18,19,37,edad 80
06505,Magdalena,82,13,28,41,edad 80
06505,Magdalena,83,12,29,41,edad 80
06505,Magdalena,84,13,27,40,edad 80
06505,Magdalena,85,11,24,35,edad 80
06505,Magdalena,86,10,6,16,edad 80
06505,Magdalena,87,6,20,26,edad 80
06505,Magdalena,88,5,12,17,edad 80
06505,Magdalena,89,12,8,20,edad 80
06505,Magdalena,90,3,7,10,edad 90
06505,Magdalena,91,0,7,7,edad 90
06505,Magdalena,92,3,7,10,edad 90
06505,Magdalena,93,2,6,8,edad 90
06505,Magdalena,94,1,1,2,edad 90
06505,Magdalena,95,4,4,8,edad 90
06505,Magdalena,97,0,1,1,edad 90
06505,Magdalena,98,0,1,1,edad 90
06505,Magdalena,99,1,2,3,edad 90
06511,Maipú,0,83,76,159,edad 0
06511,Maipú,1,74,81,155,edad 0
06511,Maipú,2,82,82,164,edad 0
06511,Maipú,3,88,91,179,edad 0
06511,Maipú,4,82,74,156,edad 0
06511,Maipú,5,103,77,180,edad 0
06511,Maipú,6,99,66,165,edad 0
06511,Maipú,7,95,109,204,edad 0
06511,Maipú,8,87,88,175,edad 0
06511,Maipú,9,75,92,167,edad 0
06511,Maipú,10,94,94,188,edad 10
06511,Maipú,11,84,104,188,edad 10
06511,Maipú,12,76,85,161,edad 10
06511,Maipú,13,79,98,177,edad 10
06511,Maipú,14,94,92,186,edad 10
06511,Maipú,15,93,93,186,edad 10
06511,Maipú,16,83,100,183,edad 10
06511,Maipú,17,75,99,174,edad 10
06511,Maipú,18,89,100,189,edad 10
06511,Maipú,19,79,70,149,edad 10
06511,Maipú,20,87,81,168,edad 20
06511,Maipú,21,87,78,165,edad 20
06511,Maipú,22,70,68,138,edad 20
06511,Maipú,23,63,84,147,edad 20
06511,Maipú,24,62,61,123,edad 20
06511,Maipú,25,65,73,138,edad 20
06511,Maipú,26,61,54,115,edad 20
06511,Maipú,27,54,61,115,edad 20
06511,Maipú,28,71,68,139,edad 20
06511,Maipú,29,60,68,128,edad 20
06511,Maipú,30,61,73,134,edad 30
06511,Maipú,31,62,84,146,edad 30
06511,Maipú,32,46,50,96,edad 30
06511,Maipú,33,63,61,124,edad 30
06511,Maipú,34,50,64,114,edad 30
06511,Maipú,35,50,71,121,edad 30
06511,Maipú,36,54,55,109,edad 30
06511,Maipú,37,54,68,122,edad 30
06511,Maipú,38,53,65,118,edad 30
06511,Maipú,39,60,66,126,edad 30
06511,Maipú,40,71,65,136,edad 40
06511,Maipú,41,65,61,126,edad 40
06511,Maipú,42,58,76,134,edad 40
06511,Maipú,43,60,62,122,edad 40
06511,Maipú,44,46,56,102,edad 40
06511,Maipú,45,65,54,119,edad 40
06511,Maipú,46,52,52,104,edad 40
06511,Maipú,47,57,71,128,edad 40
06511,Maipú,48,53,52,105,edad 40
06511,Maipú,49,46,60,106,edad 40
06511,Maipú,50,57,72,129,edad 50
06511,Maipú,51,63,71,134,edad 50
06511,Maipú,52,61,52,113,edad 50
06511,Maipú,53,65,47,112,edad 50
06511,Maipú,54,56,63,119,edad 50
06511,Maipú,55,48,65,113,edad 50
06511,Maipú,56,57,56,113,edad 50
06511,Maipú,57,55,53,108,edad 50
06511,Maipú,58,63,58,121,edad 50
06511,Maipú,59,49,42,91,edad 50
06511,Maipú,60,48,57,105,edad 60
06511,Maipú,61,41,40,81,edad 60
06511,Maipú,62,37,45,82,edad 60
06511,Maipú,63,32,37,69,edad 60
06511,Maipú,64,30,38,68,edad 60
06511,Maipú,65,42,44,86,edad 60
06511,Maipú,66,41,35,76,edad 60
06511,Maipú,67,24,44,68,edad 60
06511,Maipú,68,37,44,81,edad 60
06511,Maipú,69,39,44,83,edad 60
06511,Maipú,70,32,40,72,edad 70
06511,Maipú,71,44,42,86,edad 70
06511,Maipú,72,28,44,72,edad 70
06511,Maipú,73,31,41,72,edad 70
06511,Maipú,74,32,41,73,edad 70
06511,Maipú,75,27,42,69,edad 70
06511,Maipú,76,24,39,63,edad 70
06511,Maipú,77,20,28,48,edad 70
06511,Maipú,78,22,42,64,edad 70
06511,Maipú,79,25,29,54,edad 70
06511,Maipú,80,14,39,53,edad 80
06511,Maipú,81,16,16,32,edad 80
06511,Maipú,82,14,23,37,edad 80
06511,Maipú,83,12,12,24,edad 80
06511,Maipú,84,4,21,25,edad 80
06511,Maipú,85,3,15,18,edad 80
06511,Maipú,86,14,20,34,edad 80
06511,Maipú,87,3,21,24,edad 80
06511,Maipú,88,5,14,19,edad 80
06511,Maipú,89,2,11,13,edad 80
06511,Maipú,90,3,8,11,edad 90
06511,Maipú,91,3,3,6,edad 90
06511,Maipú,92,0,3,3,edad 90
06511,Maipú,93,2,4,6,edad 90
06511,Maipú,94,1,3,4,edad 90
06511,Maipú,95,1,4,5,edad 90
06511,Maipú,98,0,1,1,edad 90
06518,Mar Chiquita,0,140,137,277,edad 0
06518,Mar Chiquita,1,137,151,288,edad 0
06518,Mar Chiquita,2,161,150,311,edad 0
06518,Mar Chiquita,3,157,128,285,edad 0
06518,Mar Chiquita,4,151,140,291,edad 0
06518,Mar Chiquita,5,160,168,328,edad 0
06518,Mar Chiquita,6,151,169,320,edad 0
06518,Mar Chiquita,7,140,164,304,edad 0
06518,Mar Chiquita,8,172,175,347,edad 0
06518,Mar Chiquita,9,165,157,322,edad 0
06518,Mar Chiquita,10,181,174,355,edad 10
06518,Mar Chiquita,11,179,147,326,edad 10
06518,Mar Chiquita,12,167,137,304,edad 10
06518,Mar Chiquita,13,164,157,321,edad 10
06518,Mar Chiquita,14,156,145,301,edad 10
06518,Mar Chiquita,15,178,150,328,edad 10
06518,Mar Chiquita,16,147,141,288,edad 10
06518,Mar Chiquita,17,145,143,288,edad 10
06518,Mar Chiquita,18,164,149,313,edad 10
06518,Mar Chiquita,19,166,144,310,edad 10
06518,Mar Chiquita,20,169,140,309,edad 20
06518,Mar Chiquita,21,152,151,303,edad 20
06518,Mar Chiquita,22,139,138,277,edad 20
06518,Mar Chiquita,23,124,125,249,edad 20
06518,Mar Chiquita,24,128,140,268,edad 20
06518,Mar Chiquita,25,117,131,248,edad 20
06518,Mar Chiquita,26,124,115,239,edad 20
06518,Mar Chiquita,27,118,113,231,edad 20
06518,Mar Chiquita,28,118,131,249,edad 20
06518,Mar Chiquita,29,81,137,218,edad 20
06518,Mar Chiquita,30,101,117,218,edad 30
06518,Mar Chiquita,31,90,118,208,edad 30
06518,Mar Chiquita,32,112,125,237,edad 30
06518,Mar Chiquita,33,91,101,192,edad 30
06518,Mar Chiquita,34,105,95,200,edad 30
06518,Mar Chiquita,35,102,102,204,edad 30
06518,Mar Chiquita,36,116,108,224,edad 30
06518,Mar Chiquita,37,105,108,213,edad 30
06518,Mar Chiquita,38,102,107,209,edad 30
06518,Mar Chiquita,39,90,92,182,edad 30
06518,Mar Chiquita,40,115,109,224,edad 40
06518,Mar Chiquita,41,88,94,182,edad 40
06518,Mar Chiquita,42,98,115,213,edad 40
06518,Mar Chiquita,43,86,94,180,edad 40
06518,Mar Chiquita,44,89,80,169,edad 40
06518,Mar Chiquita,45,103,113,216,edad 40
06518,Mar Chiquita,46,88,107,195,edad 40
06518,Mar Chiquita,47,102,101,203,edad 40
06518,Mar Chiquita,48,95,82,177,edad 40
06518,Mar Chiquita,49,90,99,189,edad 40
06518,Mar Chiquita,50,108,122,230,edad 50
06518,Mar Chiquita,51,106,101,207,edad 50
06518,Mar Chiquita,52,122,111,233,edad 50
06518,Mar Chiquita,53,99,90,189,edad 50
06518,Mar Chiquita,54,90,90,180,edad 50
06518,Mar Chiquita,55,103,88,191,edad 50
06518,Mar Chiquita,56,95,100,195,edad 50
06518,Mar Chiquita,57,87,92,179,edad 50
06518,Mar Chiquita,58,100,105,205,edad 50
06518,Mar Chiquita,59,81,73,154,edad 50
06518,Mar Chiquita,60,94,79,173,edad 60
06518,Mar Chiquita,61,89,78,167,edad 60
06518,Mar Chiquita,62,89,84,173,edad 60
06518,Mar Chiquita,63,90,80,170,edad 60
06518,Mar Chiquita,64,67,59,126,edad 60
06518,Mar Chiquita,65,88,90,178,edad 60
06518,Mar Chiquita,66,74,73,147,edad 60
06518,Mar Chiquita,67,69,76,145,edad 60
06518,Mar Chiquita,68,72,75,147,edad 60
06518,Mar Chiquita,69,65,73,138,edad 60
06518,Mar Chiquita,70,71,87,158,edad 70
06518,Mar Chiquita,71,68,70,138,edad 70
06518,Mar Chiquita,72,65,63,128,edad 70
06518,Mar Chiquita,73,51,55,106,edad 70
06518,Mar Chiquita,74,48,52,100,edad 70
06518,Mar Chiquita,75,60,58,118,edad 70
06518,Mar Chiquita,76,41,34,75,edad 70
06518,Mar Chiquita,77,41,47,88,edad 70
06518,Mar Chiquita,78,54,48,102,edad 70
06518,Mar Chiquita,79,31,45,76,edad 70
06518,Mar Chiquita,80,30,47,77,edad 80
06518,Mar Chiquita,81,26,40,66,edad 80
06518,Mar Chiquita,82,26,23,49,edad 80
06518,Mar Chiquita,83,20,22,42,edad 80
06518,Mar Chiquita,84,17,17,34,edad 80
06518,Mar Chiquita,85,16,25,41,edad 80
06518,Mar Chiquita,86,10,24,34,edad 80
06518,Mar Chiquita,87,7,19,26,edad 80
06518,Mar Chiquita,88,10,15,25,edad 80
06518,Mar Chiquita,89,2,7,9,edad 80
06518,Mar Chiquita,90,3,7,10,edad 90
06518,Mar Chiquita,91,6,2,8,edad 90
06518,Mar Chiquita,92,2,7,9,edad 90
06518,Mar Chiquita,93,2,5,7,edad 90
06518,Mar Chiquita,94,4,8,12,edad 90
06518,Mar Chiquita,95,1,3,4,edad 90
06518,Mar Chiquita,96,1,3,4,edad 90
06518,Mar Chiquita,97,2,0,2,edad 90
06525,Marcos Paz,0,432,479,911,edad 0
06525,Marcos Paz,1,429,406,835,edad 0
06525,Marcos Paz,2,461,475,936,edad 0
06525,Marcos Paz,3,476,478,954,edad 0
06525,Marcos Paz,4,524,438,962,edad 0
06525,Marcos Paz,5,488,470,958,edad 0
06525,Marcos Paz,6,492,490,982,edad 0
06525,Marcos Paz,7,537,436,973,edad 0
06525,Marcos Paz,8,470,483,953,edad 0
06525,Marcos Paz,9,487,458,945,edad 0
06525,Marcos Paz,10,559,468,1027,edad 10
06525,Marcos Paz,11,473,495,968,edad 10
06525,Marcos Paz,12,475,464,939,edad 10
06525,Marcos Paz,13,427,468,895,edad 10
06525,Marcos Paz,14,430,438,868,edad 10
06525,Marcos Paz,15,409,439,848,edad 10
06525,Marcos Paz,16,394,387,781,edad 10
06525,Marcos Paz,17,386,378,764,edad 10
06525,Marcos Paz,18,405,358,763,edad 10
06525,Marcos Paz,19,419,392,811,edad 10
06525,Marcos Paz,20,471,374,845,edad 20
06525,Marcos Paz,21,443,352,795,edad 20
06525,Marcos Paz,22,452,360,812,edad 20
06525,Marcos Paz,23,418,355,773,edad 20
06525,Marcos Paz,24,424,308,732,edad 20
06525,Marcos Paz,25,399,337,736,edad 20
06525,Marcos Paz,26,342,306,648,edad 20
06525,Marcos Paz,27,312,342,654,edad 20
06525,Marcos Paz,28,338,314,652,edad 20
06525,Marcos Paz,29,356,297,653,edad 20
06525,Marcos Paz,30,335,330,665,edad 30
06525,Marcos Paz,31,334,292,626,edad 30
06525,Marcos Paz,32,341,263,604,edad 30
06525,Marcos Paz,33,298,284,582,edad 30
06525,Marcos Paz,34,324,266,590,edad 30
06525,Marcos Paz,35,314,266,580,edad 30
06525,Marcos Paz,36,298,297,595,edad 30
06525,Marcos Paz,37,288,271,559,edad 30
06525,Marcos Paz,38,311,268,579,edad 30
06525,Marcos Paz,39,286,250,536,edad 30
06525,Marcos Paz,40,297,270,567,edad 40
06525,Marcos Paz,41,296,225,521,edad 40
06525,Marcos Paz,42,293,272,565,edad 40
06525,Marcos Paz,43,250,249,499,edad 40
06525,Marcos Paz,44,216,206,422,edad 40
06525,Marcos Paz,45,236,219,455,edad 40
06525,Marcos Paz,46,251,206,457,edad 40
06525,Marcos Paz,47,226,199,425,edad 40
06525,Marcos Paz,48,236,207,443,edad 40
06525,Marcos Paz,49,226,196,422,edad 40
06525,Marcos Paz,50,225,188,413,edad 50
06525,Marcos Paz,51,211,187,398,edad 50
06525,Marcos Paz,52,191,172,363,edad 50
06525,Marcos Paz,53,211,184,395,edad 50
06525,Marcos Paz,54,185,157,342,edad 50
06525,Marcos Paz,55,161,145,306,edad 50
06525,Marcos Paz,56,172,161,333,edad 50
06525,Marcos Paz,57,134,155,289,edad 50
06525,Marcos Paz,58,129,114,243,edad 50
06525,Marcos Paz,59,124,118,242,edad 50
06525,Marcos Paz,60,126,125,251,edad 60
06525,Marcos Paz,61,108,120,228,edad 60
06525,Marcos Paz,62,123,105,228,edad 60
06525,Marcos Paz,63,123,101,224,edad 60
06525,Marcos Paz,64,110,102,212,edad 60
06525,Marcos Paz,65,87,111,198,edad 60
06525,Marcos Paz,66,106,81,187,edad 60
06525,Marcos Paz,67,81,86,167,edad 60
06525,Marcos Paz,68,81,97,178,edad 60
06525,Marcos Paz,69,79,97,176,edad 60
06525,Marcos Paz,70,82,99,181,edad 70
06525,Marcos Paz,71,79,88,167,edad 70
06525,Marcos Paz,72,81,93,174,edad 70
06525,Marcos Paz,73,64,72,136,edad 70
06525,Marcos Paz,74,68,79,147,edad 70
06525,Marcos Paz,75,54,88,142,edad 70
06525,Marcos Paz,76,53,71,124,edad 70
06525,Marcos Paz,77,39,61,100,edad 70
06525,Marcos Paz,78,49,62,111,edad 70
06525,Marcos Paz,79,31,58,89,edad 70
06525,Marcos Paz,80,37,61,98,edad 80
06525,Marcos Paz,81,36,52,88,edad 80
06525,Marcos Paz,82,26,44,70,edad 80
06525,Marcos Paz,83,30,31,61,edad 80
06525,Marcos Paz,84,17,32,49,edad 80
06525,Marcos Paz,85,11,25,36,edad 80
06525,Marcos Paz,86,11,30,41,edad 80
06525,Marcos Paz,87,13,28,41,edad 80
06525,Marcos Paz,88,7,23,30,edad 80
06525,Marcos Paz,89,8,12,20,edad 80
06525,Marcos Paz,90,3,15,18,edad 90
06525,Marcos Paz,91,5,6,11,edad 90
06525,Marcos Paz,92,1,5,6,edad 90
06525,Marcos Paz,93,1,3,4,edad 90
06525,Marcos Paz,94,4,2,6,edad 90
06525,Marcos Paz,95,1,1,2,edad 90
06525,Marcos Paz,96,0,1,1,edad 90
06525,Marcos Paz,97,1,2,3,edad 90
06525,Marcos Paz,98,1,2,3,edad 90
06532,Mercedes,0,497,483,980,edad 0
06532,Mercedes,1,470,465,935,edad 0
06532,Mercedes,2,502,482,984,edad 0
06532,Mercedes,3,471,495,966,edad 0
06532,Mercedes,4,484,487,971,edad 0
06532,Mercedes,5,510,484,994,edad 0
06532,Mercedes,6,473,459,932,edad 0
06532,Mercedes,7,506,519,1025,edad 0
06532,Mercedes,8,487,522,1009,edad 0
06532,Mercedes,9,558,505,1063,edad 0
06532,Mercedes,10,554,590,1144,edad 10
06532,Mercedes,11,558,524,1082,edad 10
06532,Mercedes,12,500,541,1041,edad 10
06532,Mercedes,13,533,543,1076,edad 10
06532,Mercedes,14,585,445,1030,edad 10
06532,Mercedes,15,537,539,1076,edad 10
06532,Mercedes,16,555,539,1094,edad 10
06532,Mercedes,17,561,535,1096,edad 10
06532,Mercedes,18,518,481,999,edad 10
06532,Mercedes,19,530,547,1077,edad 10
06532,Mercedes,20,519,437,956,edad 20
06532,Mercedes,21,574,482,1056,edad 20
06532,Mercedes,22,511,522,1033,edad 20
06532,Mercedes,23,528,484,1012,edad 20
06532,Mercedes,24,550,419,969,edad 20
06532,Mercedes,25,519,392,911,edad 20
06532,Mercedes,26,431,399,830,edad 20
06532,Mercedes,27,439,395,834,edad 20
06532,Mercedes,28,433,394,827,edad 20
06532,Mercedes,29,389,373,762,edad 20
06532,Mercedes,30,404,417,821,edad 30
06532,Mercedes,31,417,378,795,edad 30
06532,Mercedes,32,400,356,756,edad 30
06532,Mercedes,33,393,368,761,edad 30
06532,Mercedes,34,347,343,690,edad 30
06532,Mercedes,35,375,345,720,edad 30
06532,Mercedes,36,353,328,681,edad 30
06532,Mercedes,37,339,383,722,edad 30
06532,Mercedes,38,354,350,704,edad 30
06532,Mercedes,39,336,352,688,edad 30
06532,Mercedes,40,360,385,745,edad 40
06532,Mercedes,41,411,377,788,edad 40
06532,Mercedes,42,386,364,750,edad 40
06532,Mercedes,43,355,373,728,edad 40
06532,Mercedes,44,329,373,702,edad 40
06532,Mercedes,45,326,390,716,edad 40
06532,Mercedes,46,368,352,720,edad 40
06532,Mercedes,47,307,354,661,edad 40
06532,Mercedes,48,338,367,705,edad 40
06532,Mercedes,49,299,303,602,edad 40
06532,Mercedes,50,296,353,649,edad 50
06532,Mercedes,51,309,316,625,edad 50
06532,Mercedes,52,316,318,634,edad 50
06532,Mercedes,53,306,306,612,edad 50
06532,Mercedes,54,276,294,570,edad 50
06532,Mercedes,55,274,332,606,edad 50
06532,Mercedes,56,301,323,624,edad 50
06532,Mercedes,57,274,253,527,edad 50
06532,Mercedes,58,249,265,514,edad 50
06532,Mercedes,59,213,247,460,edad 50
06532,Mercedes,60,228,271,499,edad 60
06532,Mercedes,61,247,249,496,edad 60
06532,Mercedes,62,216,259,475,edad 60
06532,Mercedes,63,207,235,442,edad 60
06532,Mercedes,64,199,264,463,edad 60
06532,Mercedes,65,213,261,474,edad 60
06532,Mercedes,66,196,227,423,edad 60
06532,Mercedes,67,168,217,385,edad 60
06532,Mercedes,68,193,253,446,edad 60
06532,Mercedes,69,197,251,448,edad 60
06532,Mercedes,70,177,246,423,edad 70
06532,Mercedes,71,184,262,446,edad 70
06532,Mercedes,72,165,243,408,edad 70
06532,Mercedes,73,169,211,380,edad 70
06532,Mercedes,74,150,184,334,edad 70
06532,Mercedes,75,151,225,376,edad 70
06532,Mercedes,76,140,202,342,edad 70
06532,Mercedes,77,123,200,323,edad 70
06532,Mercedes,78,116,174,290,edad 70
06532,Mercedes,79,69,176,245,edad 70
06532,Mercedes,80,70,177,247,edad 80
06532,Mercedes,81,56,137,193,edad 80
06532,Mercedes,82,74,131,205,edad 80
06532,Mercedes,83,56,123,179,edad 80
06532,Mercedes,84,43,104,147,edad 80
06532,Mercedes,85,36,97,133,edad 80
06532,Mercedes,86,29,95,124,edad 80
06532,Mercedes,87,27,97,124,edad 80
06532,Mercedes,88,25,62,87,edad 80
06532,Mercedes,89,18,46,64,edad 80
06532,Mercedes,90,14,35,49,edad 90
06532,Mercedes,91,15,33,48,edad 90
06532,Mercedes,92,5,17,22,edad 90
06532,Mercedes,93,13,24,37,edad 90
06532,Mercedes,94,1,21,22,edad 90
06532,Mercedes,95,2,11,13,edad 90
06532,Mercedes,96,0,6,6,edad 90
06532,Mercedes,97,1,4,5,edad 90
06532,Mercedes,98,1,2,3,edad 90
06532,Mercedes,99,0,1,1,edad 90
06547,Monte,0,148,133,281,edad 0
06547,Monte,1,144,132,276,edad 0
06547,Monte,2,149,152,301,edad 0
06547,Monte,3,135,148,283,edad 0
06547,Monte,4,148,167,315,edad 0
06547,Monte,5,147,171,318,edad 0
06547,Monte,6,135,141,276,edad 0
06547,Monte,7,146,129,275,edad 0
06547,Monte,8,150,143,293,edad 0
06547,Monte,9,170,159,329,edad 0
06547,Monte,10,183,175,358,edad 10
06547,Monte,11,166,159,325,edad 10
06547,Monte,12,178,137,315,edad 10
06547,Monte,13,163,150,313,edad 10
06547,Monte,14,164,155,319,edad 10
06547,Monte,15,138,134,272,edad 10
06547,Monte,16,132,146,278,edad 10
06547,Monte,17,144,139,283,edad 10
06547,Monte,18,162,135,297,edad 10
06547,Monte,19,145,154,299,edad 10
06547,Monte,20,158,163,321,edad 20
06547,Monte,21,166,153,319,edad 20
06547,Monte,22,153,165,318,edad 20
06547,Monte,23,157,138,295,edad 20
06547,Monte,24,158,127,285,edad 20
06547,Monte,25,145,139,284,edad 20
06547,Monte,26,112,138,250,edad 20
06547,Monte,27,137,124,261,edad 20
06547,Monte,28,122,111,233,edad 20
06547,Monte,29,120,145,265,edad 20
06547,Monte,30,112,128,240,edad 30
06547,Monte,31,108,123,231,edad 30
06547,Monte,32,119,102,221,edad 30
06547,Monte,33,91,109,200,edad 30
06547,Monte,34,101,90,191,edad 30
06547,Monte,35,120,100,220,edad 30
06547,Monte,36,108,84,192,edad 30
06547,Monte,37,104,94,198,edad 30
06547,Monte,38,110,111,221,edad 30
06547,Monte,39,104,108,212,edad 30
06547,Monte,40,108,127,235,edad 40
06547,Monte,41,109,99,208,edad 40
06547,Monte,42,102,108,210,edad 40
06547,Monte,43,105,94,199,edad 40
06547,Monte,44,82,118,200,edad 40
06547,Monte,45,120,99,219,edad 40
06547,Monte,46,107,120,227,edad 40
06547,Monte,47,103,95,198,edad 40
06547,Monte,48,106,95,201,edad 40
06547,Monte,49,93,80,173,edad 40
06547,Monte,50,125,105,230,edad 50
06547,Monte,51,101,100,201,edad 50
06547,Monte,52,93,89,182,edad 50
06547,Monte,53,112,92,204,edad 50
06547,Monte,54,92,90,182,edad 50
06547,Monte,55,86,93,179,edad 50
06547,Monte,56,89,83,172,edad 50
06547,Monte,57,75,77,152,edad 50
06547,Monte,58,84,81,165,edad 50
06547,Monte,59,70,66,136,edad 50
06547,Monte,60,74,82,156,edad 60
06547,Monte,61,77,69,146,edad 60
06547,Monte,62,66,74,140,edad 60
06547,Monte,63,55,69,124,edad 60
06547,Monte,64,53,59,112,edad 60
06547,Monte,65,67,72,139,edad 60
06547,Monte,66,53,57,110,edad 60
06547,Monte,67,56,55,111,edad 60
06547,Monte,68,59,67,126,edad 60
06547,Monte,69,45,56,101,edad 60
06547,Monte,70,58,77,135,edad 70
06547,Monte,71,46,65,111,edad 70
06547,Monte,72,44,60,104,edad 70
06547,Monte,73,38,61,99,edad 70
06547,Monte,74,43,54,97,edad 70
06547,Monte,75,24,53,77,edad 70
06547,Monte,76,41,55,96,edad 70
06547,Monte,77,31,45,76,edad 70
06547,Monte,78,35,43,78,edad 70
06547,Monte,79,21,37,58,edad 70
06547,Monte,80,25,41,66,edad 80
06547,Monte,81,26,40,66,edad 80
06547,Monte,82,13,26,39,edad 80
06547,Monte,83,15,30,45,edad 80
06547,Monte,84,15,21,36,edad 80
06547,Monte,85,9,21,30,edad 80
06547,Monte,86,11,23,34,edad 80
06547,Monte,87,11,31,42,edad 80
06547,Monte,88,8,19,27,edad 80
06547,Monte,89,3,15,18,edad 80
06547,Monte,90,2,9,11,edad 90
06547,Monte,91,3,13,16,edad 90
06547,Monte,92,2,8,10,edad 90
06547,Monte,93,0,6,6,edad 90
06547,Monte,94,1,2,3,edad 90
06547,Monte,95,1,2,3,edad 90
06547,Monte,96,0,1,1,edad 90
06547,Monte,97,0,1,1,edad 90
06547,Monte,98,0,1,1,edad 90
06553,Monte Hermoso,0,55,40,95,edad 0
06553,Monte Hermoso,1,44,34,78,edad 0
06553,Monte Hermoso,2,40,35,75,edad 0
06553,Monte Hermoso,3,55,40,95,edad 0
06553,Monte Hermoso,4,49,43,92,edad 0
06553,Monte Hermoso,5,45,58,103,edad 0
06553,Monte Hermoso,6,45,39,84,edad 0
06553,Monte Hermoso,7,40,44,84,edad 0
06553,Monte Hermoso,8,52,33,85,edad 0
06553,Monte Hermoso,9,56,47,103,edad 0
06553,Monte Hermoso,10,49,58,107,edad 10
06553,Monte Hermoso,11,57,54,111,edad 10
06553,Monte Hermoso,12,53,45,98,edad 10
06553,Monte Hermoso,13,54,40,94,edad 10
06553,Monte Hermoso,14,58,46,104,edad 10
06553,Monte Hermoso,15,55,50,105,edad 10
06553,Monte Hermoso,16,45,42,87,edad 10
06553,Monte Hermoso,17,40,40,80,edad 10
06553,Monte Hermoso,18,49,43,92,edad 10
06553,Monte Hermoso,19,35,34,69,edad 10
06553,Monte Hermoso,20,51,40,91,edad 20
06553,Monte Hermoso,21,42,47,89,edad 20
06553,Monte Hermoso,22,42,36,78,edad 20
06553,Monte Hermoso,23,50,41,91,edad 20
06553,Monte Hermoso,24,30,42,72,edad 20
06553,Monte Hermoso,25,50,41,91,edad 20
06553,Monte Hermoso,26,42,33,75,edad 20
06553,Monte Hermoso,27,40,26,66,edad 20
06553,Monte Hermoso,28,33,32,65,edad 20
06553,Monte Hermoso,29,41,43,84,edad 20
06553,Monte Hermoso,30,44,40,84,edad 30
06553,Monte Hermoso,31,28,26,54,edad 30
06553,Monte Hermoso,32,23,35,58,edad 30
06553,Monte Hermoso,33,32,33,65,edad 30
06553,Monte Hermoso,34,31,39,70,edad 30
06553,Monte Hermoso,35,38,40,78,edad 30
06553,Monte Hermoso,36,34,39,73,edad 30
06553,Monte Hermoso,37,39,22,61,edad 30
06553,Monte Hermoso,38,28,37,65,edad 30
06553,Monte Hermoso,39,44,42,86,edad 30
06553,Monte Hermoso,40,32,31,63,edad 40
06553,Monte Hermoso,41,28,26,54,edad 40
06553,Monte Hermoso,42,24,36,60,edad 40
06553,Monte Hermoso,43,32,30,62,edad 40
06553,Monte Hermoso,44,30,29,59,edad 40
06553,Monte Hermoso,45,26,33,59,edad 40
06553,Monte Hermoso,46,35,38,73,edad 40
06553,Monte Hermoso,47,30,29,59,edad 40
06553,Monte Hermoso,48,31,29,60,edad 40
06553,Monte Hermoso,49,34,33,67,edad 40
06553,Monte Hermoso,50,27,33,60,edad 50
06553,Monte Hermoso,51,37,34,71,edad 50
06553,Monte Hermoso,52,38,29,67,edad 50
06553,Monte Hermoso,53,36,33,69,edad 50
06553,Monte Hermoso,54,43,39,82,edad 50
06553,Monte Hermoso,55,42,28,70,edad 50
06553,Monte Hermoso,56,28,38,66,edad 50
06553,Monte Hermoso,57,28,44,72,edad 50
06553,Monte Hermoso,58,36,29,65,edad 50
06553,Monte Hermoso,59,29,32,61,edad 50
06553,Monte Hermoso,60,22,32,54,edad 60
06553,Monte Hermoso,61,28,32,60,edad 60
06553,Monte Hermoso,62,21,28,49,edad 60
06553,Monte Hermoso,63,28,27,55,edad 60
06553,Monte Hermoso,64,25,29,54,edad 60
06553,Monte Hermoso,65,26,22,48,edad 60
06553,Monte Hermoso,66,19,18,37,edad 60
06553,Monte Hermoso,67,35,18,53,edad 60
06553,Monte Hermoso,68,24,25,49,edad 60
06553,Monte Hermoso,69,30,20,50,edad 60
06553,Monte Hermoso,70,24,27,51,edad 70
06553,Monte Hermoso,71,18,25,43,edad 70
06553,Monte Hermoso,72,27,19,46,edad 70
06553,Monte Hermoso,73,21,22,43,edad 70
06553,Monte Hermoso,74,17,13,30,edad 70
06553,Monte Hermoso,75,19,16,35,edad 70
06553,Monte Hermoso,76,12,9,21,edad 70
06553,Monte Hermoso,77,13,26,39,edad 70
06553,Monte Hermoso,78,10,15,25,edad 70
06553,Monte Hermoso,79,13,11,24,edad 70
06553,Monte Hermoso,80,11,16,27,edad 80
06553,Monte Hermoso,81,8,6,14,edad 80
06553,Monte Hermoso,82,4,9,13,edad 80
06553,Monte Hermoso,83,5,3,8,edad 80
06553,Monte Hermoso,84,2,8,10,edad 80
06553,Monte Hermoso,85,2,3,5,edad 80
06553,Monte Hermoso,86,0,4,4,edad 80
06553,Monte Hermoso,87,3,3,6,edad 80
06553,Monte Hermoso,88,1,2,3,edad 80
06553,Monte Hermoso,89,2,0,2,edad 80
06553,Monte Hermoso,90,1,1,2,edad 90
06553,Monte Hermoso,91,1,2,3,edad 90
06553,Monte Hermoso,92,0,1,1,edad 90
06553,Monte Hermoso,94,1,0,1,edad 90
06553,Monte Hermoso,95,0,1,1,edad 90
06574,Navarro,0,128,149,277,edad 0
06574,Navarro,1,141,136,277,edad 0
06574,Navarro,2,117,140,257,edad 0
06574,Navarro,3,169,152,321,edad 0
06574,Navarro,4,150,145,295,edad 0
06574,Navarro,5,144,170,314,edad 0
06574,Navarro,6,139,142,281,edad 0
06574,Navarro,7,168,129,297,edad 0
06574,Navarro,8,161,129,290,edad 0
06574,Navarro,9,161,149,310,edad 0
06574,Navarro,10,168,169,337,edad 10
06574,Navarro,11,144,171,315,edad 10
06574,Navarro,12,162,162,324,edad 10
06574,Navarro,13,148,142,290,edad 10
06574,Navarro,14,159,162,321,edad 10
06574,Navarro,15,150,118,268,edad 10
06574,Navarro,16,141,152,293,edad 10
06574,Navarro,17,141,118,259,edad 10
06574,Navarro,18,140,123,263,edad 10
06574,Navarro,19,126,127,253,edad 10
06574,Navarro,20,121,107,228,edad 20
06574,Navarro,21,128,139,267,edad 20
06574,Navarro,22,131,106,237,edad 20
06574,Navarro,23,115,106,221,edad 20
06574,Navarro,24,122,119,241,edad 20
06574,Navarro,25,103,107,210,edad 20
06574,Navarro,26,93,98,191,edad 20
06574,Navarro,27,101,109,210,edad 20
06574,Navarro,28,110,95,205,edad 20
06574,Navarro,29,93,99,192,edad 20
06574,Navarro,30,91,95,186,edad 30
06574,Navarro,31,85,91,176,edad 30
06574,Navarro,32,96,83,179,edad 30
06574,Navarro,33,77,93,170,edad 30
06574,Navarro,34,97,106,203,edad 30
06574,Navarro,35,98,97,195,edad 30
06574,Navarro,36,103,106,209,edad 30
06574,Navarro,37,119,97,216,edad 30
06574,Navarro,38,102,107,209,edad 30
06574,Navarro,39,100,108,208,edad 30
06574,Navarro,40,106,97,203,edad 40
06574,Navarro,41,113,92,205,edad 40
06574,Navarro,42,88,93,181,edad 40
06574,Navarro,43,90,80,170,edad 40
06574,Navarro,44,83,92,175,edad 40
06574,Navarro,45,98,83,181,edad 40
06574,Navarro,46,84,85,169,edad 40
06574,Navarro,47,92,90,182,edad 40
06574,Navarro,48,85,82,167,edad 40
06574,Navarro,49,71,72,143,edad 40
06574,Navarro,50,94,90,184,edad 50
06574,Navarro,51,83,88,171,edad 50
06574,Navarro,52,93,76,169,edad 50
06574,Navarro,53,73,85,158,edad 50
06574,Navarro,54,58,81,139,edad 50
06574,Navarro,55,96,66,162,edad 50
06574,Navarro,56,85,80,165,edad 50
06574,Navarro,57,79,67,146,edad 50
06574,Navarro,58,65,64,129,edad 50
06574,Navarro,59,70,64,134,edad 50
06574,Navarro,60,69,76,145,edad 60
06574,Navarro,61,54,68,122,edad 60
06574,Navarro,62,58,54,112,edad 60
06574,Navarro,63,50,63,113,edad 60
06574,Navarro,64,61,59,120,edad 60
06574,Navarro,65,46,57,103,edad 60
06574,Navarro,66,52,69,121,edad 60
06574,Navarro,67,56,40,96,edad 60
06574,Navarro,68,54,63,117,edad 60
06574,Navarro,69,48,57,105,edad 60
06574,Navarro,70,47,57,104,edad 70
06574,Navarro,71,49,56,105,edad 70
06574,Navarro,72,55,58,113,edad 70
06574,Navarro,73,34,54,88,edad 70
06574,Navarro,74,40,47,87,edad 70
06574,Navarro,75,36,42,78,edad 70
06574,Navarro,76,34,45,79,edad 70
06574,Navarro,77,37,42,79,edad 70
06574,Navarro,78,24,48,72,edad 70
06574,Navarro,79,26,33,59,edad 70
06574,Navarro,80,28,36,64,edad 80
06574,Navarro,81,14,36,50,edad 80
06574,Navarro,82,20,32,52,edad 80
06574,Navarro,83,13,22,35,edad 80
06574,Navarro,84,17,29,46,edad 80
06574,Navarro,85,7,20,27,edad 80
06574,Navarro,86,10,27,37,edad 80
06574,Navarro,87,11,22,33,edad 80
06574,Navarro,88,6,19,25,edad 80
06574,Navarro,89,7,16,23,edad 80
06574,Navarro,90,8,12,20,edad 90
06574,Navarro,91,3,4,7,edad 90
06574,Navarro,92,1,9,10,edad 90
06574,Navarro,93,4,5,9,edad 90
06574,Navarro,94,0,3,3,edad 90
06574,Navarro,95,0,2,2,edad 90
06574,Navarro,96,1,3,4,edad 90
06574,Navarro,97,1,2,3,edad 90
06574,Navarro,99,0,1,1,edad 90
06581,Necochea,0,722,718,1440,edad 0
06581,Necochea,1,672,605,1277,edad 0
06581,Necochea,2,722,696,1418,edad 0
06581,Necochea,3,741,727,1468,edad 0
06581,Necochea,4,714,721,1435,edad 0
06581,Necochea,5,732,728,1460,edad 0
06581,Necochea,6,747,756,1503,edad 0
06581,Necochea,7,773,699,1472,edad 0
06581,Necochea,8,770,766,1536,edad 0
06581,Necochea,9,808,816,1624,edad 0
06581,Necochea,10,865,824,1689,edad 10
06581,Necochea,11,799,812,1611,edad 10
06581,Necochea,12,825,776,1601,edad 10
06581,Necochea,13,770,761,1531,edad 10
06581,Necochea,14,824,770,1594,edad 10
06581,Necochea,15,829,749,1578,edad 10
06581,Necochea,16,833,805,1638,edad 10
06581,Necochea,17,800,760,1560,edad 10
06581,Necochea,18,723,644,1367,edad 10
06581,Necochea,19,746,628,1374,edad 10
06581,Necochea,20,672,645,1317,edad 20
06581,Necochea,21,664,705,1369,edad 20
06581,Necochea,22,596,644,1240,edad 20
06581,Necochea,23,611,596,1207,edad 20
06581,Necochea,24,560,576,1136,edad 20
06581,Necochea,25,572,572,1144,edad 20
06581,Necochea,26,517,571,1088,edad 20
06581,Necochea,27,499,547,1046,edad 20
06581,Necochea,28,557,591,1148,edad 20
06581,Necochea,29,529,577,1106,edad 20
06581,Necochea,30,536,596,1132,edad 30
06581,Necochea,31,511,509,1020,edad 30
06581,Necochea,32,494,554,1048,edad 30
06581,Necochea,33,531,550,1081,edad 30
06581,Necochea,34,510,602,1112,edad 30
06581,Necochea,35,487,520,1007,edad 30
06581,Necochea,36,541,602,1143,edad 30
06581,Necochea,37,558,632,1190,edad 30
06581,Necochea,38,576,627,1203,edad 30
06581,Necochea,39,519,541,1060,edad 30
06581,Necochea,40,552,598,1150,edad 40
06581,Necochea,41,542,576,1118,edad 40
06581,Necochea,42,518,556,1074,edad 40
06581,Necochea,43,545,577,1122,edad 40
06581,Necochea,44,504,565,1069,edad 40
06581,Necochea,45,549,581,1130,edad 40
06581,Necochea,46,508,521,1029,edad 40
06581,Necochea,47,460,479,939,edad 40
06581,Necochea,48,461,527,988,edad 40
06581,Necochea,49,443,486,929,edad 40
06581,Necochea,50,480,579,1059,edad 50
06581,Necochea,51,479,502,981,edad 50
06581,Necochea,52,492,558,1050,edad 50
06581,Necochea,53,468,548,1016,edad 50
06581,Necochea,54,422,488,910,edad 50
06581,Necochea,55,440,497,937,edad 50
06581,Necochea,56,474,533,1007,edad 50
06581,Necochea,57,420,453,873,edad 50
06581,Necochea,58,423,453,876,edad 50
06581,Necochea,59,390,425,815,edad 50
06581,Necochea,60,435,475,910,edad 60
06581,Necochea,61,375,411,786,edad 60
06581,Necochea,62,374,424,798,edad 60
06581,Necochea,63,329,420,749,edad 60
06581,Necochea,64,389,401,790,edad 60
06581,Necochea,65,362,409,771,edad 60
06581,Necochea,66,339,417,756,edad 60
06581,Necochea,67,322,386,708,edad 60
06581,Necochea,68,321,379,700,edad 60
06581,Necochea,69,317,402,719,edad 60
06581,Necochea,70,349,414,763,edad 70
06581,Necochea,71,299,378,677,edad 70
06581,Necochea,72,260,379,639,edad 70
06581,Necochea,73,259,381,640,edad 70
06581,Necochea,74,247,341,588,edad 70
06581,Necochea,75,254,313,567,edad 70
06581,Necochea,76,212,318,530,edad 70
06581,Necochea,77,186,305,491,edad 70
06581,Necochea,78,199,257,456,edad 70
06581,Necochea,79,162,274,436,edad 70
06581,Necochea,80,148,282,430,edad 80
06581,Necochea,81,131,193,324,edad 80
06581,Necochea,82,106,207,313,edad 80
06581,Necochea,83,90,169,259,edad 80
06581,Necochea,84,82,162,244,edad 80
06581,Necochea,85,59,141,200,edad 80
06581,Necochea,86,33,126,159,edad 80
06581,Necochea,87,38,104,142,edad 80
06581,Necochea,88,34,78,112,edad 80
06581,Necochea,89,21,67,88,edad 80
06581,Necochea,90,21,64,85,edad 90
06581,Necochea,91,18,42,60,edad 90
06581,Necochea,92,14,33,47,edad 90
06581,Necochea,93,14,24,38,edad 90
06581,Necochea,94,4,21,25,edad 90
06581,Necochea,95,5,13,18,edad 90
06581,Necochea,96,4,7,11,edad 90
06581,Necochea,97,0,9,9,edad 90
06581,Necochea,98,2,6,8,edad 90
06581,Necochea,99,1,3,4,edad 90
06588,9 de Julio,0,390,391,781,edad 0
06588,9 de Julio,1,353,329,682,edad 0
06588,9 de Julio,2,365,385,750,edad 0
06588,9 de Julio,3,397,379,776,edad 0
06588,9 de Julio,4,396,363,759,edad 0
06588,9 de Julio,5,405,403,808,edad 0
06588,9 de Julio,6,351,367,718,edad 0
06588,9 de Julio,7,365,364,729,edad 0
06588,9 de Julio,8,386,403,789,edad 0
06588,9 de Julio,9,397,417,814,edad 0
06588,9 de Julio,10,451,380,831,edad 10
06588,9 de Julio,11,381,419,800,edad 10
06588,9 de Julio,12,367,377,744,edad 10
06588,9 de Julio,13,395,342,737,edad 10
06588,9 de Julio,14,364,400,764,edad 10
06588,9 de Julio,15,380,372,752,edad 10
06588,9 de Julio,16,370,312,682,edad 10
06588,9 de Julio,17,328,336,664,edad 10
06588,9 de Julio,18,339,339,678,edad 10
06588,9 de Julio,19,314,309,623,edad 10
06588,9 de Julio,20,301,293,594,edad 20
06588,9 de Julio,21,326,351,677,edad 20
06588,9 de Julio,22,306,329,635,edad 20
06588,9 de Julio,23,309,330,639,edad 20
06588,9 de Julio,24,284,287,571,edad 20
06588,9 de Julio,25,280,266,546,edad 20
06588,9 de Julio,26,292,312,604,edad 20
06588,9 de Julio,27,301,275,576,edad 20
06588,9 de Julio,28,316,317,633,edad 20
06588,9 de Julio,29,279,302,581,edad 20
06588,9 de Julio,30,314,315,629,edad 30
06588,9 de Julio,31,282,277,559,edad 30
06588,9 de Julio,32,270,265,535,edad 30
06588,9 de Julio,33,245,292,537,edad 30
06588,9 de Julio,34,238,263,501,edad 30
06588,9 de Julio,35,270,284,554,edad 30
06588,9 de Julio,36,294,299,593,edad 30
06588,9 de Julio,37,286,287,573,edad 30
06588,9 de Julio,38,298,346,644,edad 30
06588,9 de Julio,39,275,295,570,edad 30
06588,9 de Julio,40,294,300,594,edad 40
06588,9 de Julio,41,266,280,546,edad 40
06588,9 de Julio,42,300,273,573,edad 40
06588,9 de Julio,43,267,299,566,edad 40
06588,9 de Julio,44,242,257,499,edad 40
06588,9 de Julio,45,251,267,518,edad 40
06588,9 de Julio,46,252,256,508,edad 40
06588,9 de Julio,47,271,280,551,edad 40
06588,9 de Julio,48,232,283,515,edad 40
06588,9 de Julio,49,272,235,507,edad 40
06588,9 de Julio,50,268,274,542,edad 50
06588,9 de Julio,51,243,260,503,edad 50
06588,9 de Julio,52,271,248,519,edad 50
06588,9 de Julio,53,238,245,483,edad 50
06588,9 de Julio,54,232,264,496,edad 50
06588,9 de Julio,55,242,245,487,edad 50
06588,9 de Julio,56,270,301,571,edad 50
06588,9 de Julio,57,236,233,469,edad 50
06588,9 de Julio,58,241,234,475,edad 50
06588,9 de Julio,59,226,222,448,edad 50
06588,9 de Julio,60,217,252,469,edad 60
06588,9 de Julio,61,190,213,403,edad 60
06588,9 de Julio,62,214,214,428,edad 60
06588,9 de Julio,63,230,239,469,edad 60
06588,9 de Julio,64,195,207,402,edad 60
06588,9 de Julio,65,195,227,422,edad 60
06588,9 de Julio,66,214,244,458,edad 60
06588,9 de Julio,67,178,189,367,edad 60
06588,9 de Julio,68,166,219,385,edad 60
06588,9 de Julio,69,172,208,380,edad 60
06588,9 de Julio,70,171,221,392,edad 70
06588,9 de Julio,71,158,189,347,edad 70
06588,9 de Julio,72,185,206,391,edad 70
06588,9 de Julio,73,135,190,325,edad 70
06588,9 de Julio,74,139,204,343,edad 70
06588,9 de Julio,75,133,173,306,edad 70
06588,9 de Julio,76,133,183,316,edad 70
06588,9 de Julio,77,115,147,262,edad 70
06588,9 de Julio,78,105,169,274,edad 70
06588,9 de Julio,79,91,125,216,edad 70
06588,9 de Julio,80,69,136,205,edad 80
06588,9 de Julio,81,68,126,194,edad 80
06588,9 de Julio,82,63,121,184,edad 80
06588,9 de Julio,83,47,109,156,edad 80
06588,9 de Julio,84,47,85,132,edad 80
06588,9 de Julio,85,45,94,139,edad 80
06588,9 de Julio,86,29,78,107,edad 80
06588,9 de Julio,87,46,74,120,edad 80
06588,9 de Julio,88,24,76,100,edad 80
06588,9 de Julio,89,34,53,87,edad 80
06588,9 de Julio,90,21,41,62,edad 90
06588,9 de Julio,91,10,29,39,edad 90
06588,9 de Julio,92,16,25,41,edad 90
06588,9 de Julio,93,10,22,32,edad 90
06588,9 de Julio,94,3,12,15,edad 90
06588,9 de Julio,95,2,9,11,edad 90
06588,9 de Julio,96,3,4,7,edad 90
06588,9 de Julio,97,0,2,2,edad 90
06588,9 de Julio,98,0,1,1,edad 90
06588,9 de Julio,99,0,4,4,edad 90
06595,Olavarría,0,851,806,1657,edad 0
06595,Olavarría,1,822,772,1594,edad 0
06595,Olavarría,2,850,896,1746,edad 0
06595,Olavarría,3,949,872,1821,edad 0
06595,Olavarría,4,920,875,1795,edad 0
06595,Olavarría,5,911,869,1780,edad 0
06595,Olavarría,6,922,889,1811,edad 0
06595,Olavarría,7,855,815,1670,edad 0
06595,Olavarría,8,862,843,1705,edad 0
06595,Olavarría,9,914,872,1786,edad 0
06595,Olavarría,10,989,979,1968,edad 10
06595,Olavarría,11,964,930,1894,edad 10
06595,Olavarría,12,924,899,1823,edad 10
06595,Olavarría,13,907,830,1737,edad 10
06595,Olavarría,14,921,836,1757,edad 10
06595,Olavarría,15,851,882,1733,edad 10
06595,Olavarría,16,866,790,1656,edad 10
06595,Olavarría,17,849,828,1677,edad 10
06595,Olavarría,18,793,746,1539,edad 10
06595,Olavarría,19,862,761,1623,edad 10
06595,Olavarría,20,842,771,1613,edad 20
06595,Olavarría,21,871,779,1650,edad 20
06595,Olavarría,22,867,724,1591,edad 20
06595,Olavarría,23,766,750,1516,edad 20
06595,Olavarría,24,828,692,1520,edad 20
06595,Olavarría,25,752,740,1492,edad 20
06595,Olavarría,26,726,707,1433,edad 20
06595,Olavarría,27,785,643,1428,edad 20
06595,Olavarría,28,741,710,1451,edad 20
06595,Olavarría,29,747,707,1454,edad 20
06595,Olavarría,30,787,747,1534,edad 30
06595,Olavarría,31,723,686,1409,edad 30
06595,Olavarría,32,672,689,1361,edad 30
06595,Olavarría,33,707,661,1368,edad 30
06595,Olavarría,34,580,652,1232,edad 30
06595,Olavarría,35,678,636,1314,edad 30
06595,Olavarría,36,670,693,1363,edad 30
06595,Olavarría,37,686,635,1321,edad 30
06595,Olavarría,38,690,768,1458,edad 30
06595,Olavarría,39,705,657,1362,edad 30
06595,Olavarría,40,688,698,1386,edad 40
06595,Olavarría,41,695,613,1308,edad 40
06595,Olavarría,42,652,679,1331,edad 40
06595,Olavarría,43,640,652,1292,edad 40
06595,Olavarría,44,542,561,1103,edad 40
06595,Olavarría,45,562,633,1195,edad 40
06595,Olavarría,46,627,622,1249,edad 40
06595,Olavarría,47,605,629,1234,edad 40
06595,Olavarría,48,602,608,1210,edad 40
06595,Olavarría,49,561,613,1174,edad 40
06595,Olavarría,50,550,650,1200,edad 50
06595,Olavarría,51,563,620,1183,edad 50
06595,Olavarría,52,592,610,1202,edad 50
06595,Olavarría,53,563,601,1164,edad 50
06595,Olavarría,54,511,583,1094,edad 50
06595,Olavarría,55,556,564,1120,edad 50
06595,Olavarría,56,546,574,1120,edad 50
06595,Olavarría,57,516,525,1041,edad 50
06595,Olavarría,58,513,498,1011,edad 50
06595,Olavarría,59,434,440,874,edad 50
06595,Olavarría,60,420,503,923,edad 60
06595,Olavarría,61,405,446,851,edad 60
06595,Olavarría,62,438,483,921,edad 60
06595,Olavarría,63,383,413,796,edad 60
06595,Olavarría,64,387,460,847,edad 60
06595,Olavarría,65,426,453,879,edad 60
06595,Olavarría,66,351,425,776,edad 60
06595,Olavarría,67,360,432,792,edad 60
06595,Olavarría,68,373,440,813,edad 60
06595,Olavarría,69,338,377,715,edad 60
06595,Olavarría,70,315,445,760,edad 70
06595,Olavarría,71,332,386,718,edad 70
06595,Olavarría,72,320,386,706,edad 70
06595,Olavarría,73,292,392,684,edad 70
06595,Olavarría,74,244,343,587,edad 70
06595,Olavarría,75,255,343,598,edad 70
06595,Olavarría,76,208,336,544,edad 70
06595,Olavarría,77,209,284,493,edad 70
06595,Olavarría,78,180,284,464,edad 70
06595,Olavarría,79,140,264,404,edad 70
06595,Olavarría,80,151,271,422,edad 80
06595,Olavarría,81,126,192,318,edad 80
06595,Olavarría,82,100,208,308,edad 80
06595,Olavarría,83,86,157,243,edad 80
06595,Olavarría,84,76,160,236,edad 80
06595,Olavarría,85,65,148,213,edad 80
06595,Olavarría,86,52,108,160,edad 80
06595,Olavarría,87,38,110,148,edad 80
06595,Olavarría,88,26,90,116,edad 80
06595,Olavarría,89,12,66,78,edad 80
06595,Olavarría,90,27,63,90,edad 90
06595,Olavarría,91,12,52,64,edad 90
06595,Olavarría,92,14,29,43,edad 90
06595,Olavarría,93,7,19,26,edad 90
06595,Olavarría,94,7,26,33,edad 90
06595,Olavarría,95,1,21,22,edad 90
06595,Olavarría,96,2,13,15,edad 90
06595,Olavarría,97,3,5,8,edad 90
06595,Olavarría,98,1,6,7,edad 90
06595,Olavarría,99,1,1,2,edad 90
06602,Patagones,0,224,242,466,edad 0
06602,Patagones,1,209,222,431,edad 0
06602,Patagones,2,261,257,518,edad 0
06602,Patagones,3,268,287,555,edad 0
06602,Patagones,4,237,266,503,edad 0
06602,Patagones,5,312,269,581,edad 0
06602,Patagones,6,266,249,515,edad 0
06602,Patagones,7,270,262,532,edad 0
06602,Patagones,8,301,280,581,edad 0
06602,Patagones,9,280,295,575,edad 0
06602,Patagones,10,292,287,579,edad 10
06602,Patagones,11,242,273,515,edad 10
06602,Patagones,12,298,276,574,edad 10
06602,Patagones,13,284,276,560,edad 10
06602,Patagones,14,257,277,534,edad 10
06602,Patagones,15,273,263,536,edad 10
06602,Patagones,16,263,248,511,edad 10
06602,Patagones,17,245,243,488,edad 10
06602,Patagones,18,217,200,417,edad 10
06602,Patagones,19,212,194,406,edad 10
06602,Patagones,20,220,193,413,edad 20
06602,Patagones,21,220,208,428,edad 20
06602,Patagones,22,206,223,429,edad 20
06602,Patagones,23,185,204,389,edad 20
06602,Patagones,24,205,188,393,edad 20
06602,Patagones,25,182,195,377,edad 20
06602,Patagones,26,202,196,398,edad 20
06602,Patagones,27,195,184,379,edad 20
06602,Patagones,28,194,226,420,edad 20
06602,Patagones,29,177,185,362,edad 20
06602,Patagones,30,221,178,399,edad 30
06602,Patagones,31,167,177,344,edad 30
06602,Patagones,32,173,170,343,edad 30
06602,Patagones,33,174,182,356,edad 30
06602,Patagones,34,153,163,316,edad 30
06602,Patagones,35,158,176,334,edad 30
06602,Patagones,36,192,199,391,edad 30
06602,Patagones,37,170,165,335,edad 30
06602,Patagones,38,168,174,342,edad 30
06602,Patagones,39,169,177,346,edad 30
06602,Patagones,40,174,187,361,edad 40
06602,Patagones,41,152,155,307,edad 40
06602,Patagones,42,166,173,339,edad 40
06602,Patagones,43,184,153,337,edad 40
06602,Patagones,44,144,144,288,edad 40
06602,Patagones,45,153,164,317,edad 40
06602,Patagones,46,159,170,329,edad 40
06602,Patagones,47,154,147,301,edad 40
06602,Patagones,48,163,146,309,edad 40
06602,Patagones,49,166,121,287,edad 40
06602,Patagones,50,160,155,315,edad 50
06602,Patagones,51,152,119,271,edad 50
06602,Patagones,52,177,146,323,edad 50
06602,Patagones,53,157,152,309,edad 50
06602,Patagones,54,152,147,299,edad 50
06602,Patagones,55,154,135,289,edad 50
06602,Patagones,56,141,144,285,edad 50
06602,Patagones,57,124,129,253,edad 50
06602,Patagones,58,137,131,268,edad 50
06602,Patagones,59,117,95,212,edad 50
06602,Patagones,60,133,108,241,edad 60
06602,Patagones,61,96,100,196,edad 60
06602,Patagones,62,125,112,237,edad 60
06602,Patagones,63,109,108,217,edad 60
06602,Patagones,64,106,87,193,edad 60
06602,Patagones,65,106,115,221,edad 60
06602,Patagones,66,84,91,175,edad 60
06602,Patagones,67,90,87,177,edad 60
06602,Patagones,68,108,89,197,edad 60
06602,Patagones,69,69,89,158,edad 60
06602,Patagones,70,83,100,183,edad 70
06602,Patagones,71,76,78,154,edad 70
06602,Patagones,72,79,82,161,edad 70
06602,Patagones,73,71,88,159,edad 70
06602,Patagones,74,72,95,167,edad 70
06602,Patagones,75,63,90,153,edad 70
06602,Patagones,76,59,69,128,edad 70
06602,Patagones,77,57,72,129,edad 70
06602,Patagones,78,46,56,102,edad 70
06602,Patagones,79,31,64,95,edad 70
06602,Patagones,80,41,54,95,edad 80
06602,Patagones,81,31,43,74,edad 80
06602,Patagones,82,18,47,65,edad 80
06602,Patagones,83,21,38,59,edad 80
06602,Patagones,84,41,37,78,edad 80
06602,Patagones,85,21,40,61,edad 80
06602,Patagones,86,12,32,44,edad 80
06602,Patagones,87,5,19,24,edad 80
06602,Patagones,88,7,22,29,edad 80
06602,Patagones,89,6,17,23,edad 80
06602,Patagones,90,5,13,18,edad 90
06602,Patagones,91,4,9,13,edad 90
06602,Patagones,92,2,10,12,edad 90
06602,Patagones,93,1,4,5,edad 90
06602,Patagones,94,2,5,7,edad 90
06602,Patagones,95,3,7,10,edad 90
06602,Patagones,96,1,1,2,edad 90
06602,Patagones,97,0,1,1,edad 90
06602,Patagones,98,0,1,1,edad 90
06602,Patagones,99,1,1,2,edad 90
06609,Pehuajó,0,358,312,670,edad 0
06609,Pehuajó,1,300,309,609,edad 0
06609,Pehuajó,2,315,308,623,edad 0
06609,Pehuajó,3,340,323,663,edad 0
06609,Pehuajó,4,330,316,646,edad 0
06609,Pehuajó,5,360,345,705,edad 0
06609,Pehuajó,6,351,311,662,edad 0
06609,Pehuajó,7,378,365,743,edad 0
06609,Pehuajó,8,333,294,627,edad 0
06609,Pehuajó,9,332,320,652,edad 0
06609,Pehuajó,10,358,347,705,edad 10
06609,Pehuajó,11,385,342,727,edad 10
06609,Pehuajó,12,334,348,682,edad 10
06609,Pehuajó,13,334,316,650,edad 10
06609,Pehuajó,14,310,336,646,edad 10
06609,Pehuajó,15,351,316,667,edad 10
06609,Pehuajó,16,299,321,620,edad 10
06609,Pehuajó,17,311,318,629,edad 10
06609,Pehuajó,18,261,256,517,edad 10
06609,Pehuajó,19,241,273,514,edad 10
06609,Pehuajó,20,243,266,509,edad 20
06609,Pehuajó,21,284,238,522,edad 20
06609,Pehuajó,22,287,267,554,edad 20
06609,Pehuajó,23,239,258,497,edad 20
06609,Pehuajó,24,227,230,457,edad 20
06609,Pehuajó,25,235,261,496,edad 20
06609,Pehuajó,26,213,256,469,edad 20
06609,Pehuajó,27,282,287,569,edad 20
06609,Pehuajó,28,243,246,489,edad 20
06609,Pehuajó,29,273,254,527,edad 20
06609,Pehuajó,30,263,272,535,edad 30
06609,Pehuajó,31,247,230,477,edad 30
06609,Pehuajó,32,210,232,442,edad 30
06609,Pehuajó,33,213,243,456,edad 30
06609,Pehuajó,34,219,207,426,edad 30
06609,Pehuajó,35,226,253,479,edad 30
06609,Pehuajó,36,223,246,469,edad 30
06609,Pehuajó,37,233,231,464,edad 30
06609,Pehuajó,38,249,239,488,edad 30
06609,Pehuajó,39,214,253,467,edad 30
06609,Pehuajó,40,246,260,506,edad 40
06609,Pehuajó,41,240,227,467,edad 40
06609,Pehuajó,42,235,245,480,edad 40
06609,Pehuajó,43,243,229,472,edad 40
06609,Pehuajó,44,193,174,367,edad 40
06609,Pehuajó,45,213,236,449,edad 40
06609,Pehuajó,46,232,226,458,edad 40
06609,Pehuajó,47,231,227,458,edad 40
06609,Pehuajó,48,183,225,408,edad 40
06609,Pehuajó,49,201,196,397,edad 40
06609,Pehuajó,50,223,234,457,edad 50
06609,Pehuajó,51,254,224,478,edad 50
06609,Pehuajó,52,198,217,415,edad 50
06609,Pehuajó,53,210,249,459,edad 50
06609,Pehuajó,54,226,216,442,edad 50
06609,Pehuajó,55,198,223,421,edad 50
06609,Pehuajó,56,238,213,451,edad 50
06609,Pehuajó,57,205,209,414,edad 50
06609,Pehuajó,58,212,200,412,edad 50
06609,Pehuajó,59,155,192,347,edad 50
06609,Pehuajó,60,200,179,379,edad 60
06609,Pehuajó,61,173,165,338,edad 60
06609,Pehuajó,62,157,183,340,edad 60
06609,Pehuajó,63,174,156,330,edad 60
06609,Pehuajó,64,138,174,312,edad 60
06609,Pehuajó,65,148,192,340,edad 60
06609,Pehuajó,66,120,156,276,edad 60
06609,Pehuajó,67,128,178,306,edad 60
06609,Pehuajó,68,121,176,297,edad 60
06609,Pehuajó,69,117,163,280,edad 60
06609,Pehuajó,70,139,172,311,edad 70
06609,Pehuajó,71,139,130,269,edad 70
06609,Pehuajó,72,119,164,283,edad 70
06609,Pehuajó,73,131,169,300,edad 70
06609,Pehuajó,74,106,122,228,edad 70
06609,Pehuajó,75,102,152,254,edad 70
06609,Pehuajó,76,107,130,237,edad 70
06609,Pehuajó,77,80,121,201,edad 70
06609,Pehuajó,78,94,127,221,edad 70
06609,Pehuajó,79,67,101,168,edad 70
06609,Pehuajó,80,55,136,191,edad 80
06609,Pehuajó,81,61,92,153,edad 80
06609,Pehuajó,82,51,95,146,edad 80
06609,Pehuajó,83,35,86,121,edad 80
06609,Pehuajó,84,45,71,116,edad 80
06609,Pehuajó,85,35,62,97,edad 80
06609,Pehuajó,86,23,52,75,edad 80
06609,Pehuajó,87,23,55,78,edad 80
06609,Pehuajó,88,21,35,56,edad 80
06609,Pehuajó,89,18,25,43,edad 80
06609,Pehuajó,90,16,20,36,edad 90
06609,Pehuajó,91,8,28,36,edad 90
06609,Pehuajó,92,4,16,20,edad 90
06609,Pehuajó,93,5,13,18,edad 90
06609,Pehuajó,94,3,9,12,edad 90
06609,Pehuajó,95,4,7,11,edad 90
06609,Pehuajó,96,1,4,5,edad 90
06609,Pehuajó,97,0,5,5,edad 90
06609,Pehuajó,98,0,1,1,edad 90
06609,Pehuajó,99,1,1,2,edad 90
06616,Pellegrini,0,44,39,83,edad 0
06616,Pellegrini,1,59,45,104,edad 0
06616,Pellegrini,2,58,48,106,edad 0
06616,Pellegrini,3,40,47,87,edad 0
06616,Pellegrini,4,46,57,103,edad 0
06616,Pellegrini,5,56,56,112,edad 0
06616,Pellegrini,6,55,56,111,edad 0
06616,Pellegrini,7,60,61,121,edad 0
06616,Pellegrini,8,64,42,106,edad 0
06616,Pellegrini,9,60,43,103,edad 0
06616,Pellegrini,10,64,58,122,edad 10
06616,Pellegrini,11,53,64,117,edad 10
06616,Pellegrini,12,52,55,107,edad 10
06616,Pellegrini,13,42,53,95,edad 10
06616,Pellegrini,14,60,35,95,edad 10
06616,Pellegrini,15,59,64,123,edad 10
06616,Pellegrini,16,43,45,88,edad 10
06616,Pellegrini,17,56,50,106,edad 10
06616,Pellegrini,18,47,49,96,edad 10
06616,Pellegrini,19,56,45,101,edad 10
06616,Pellegrini,20,40,35,75,edad 20
06616,Pellegrini,21,48,48,96,edad 20
06616,Pellegrini,22,44,38,82,edad 20
06616,Pellegrini,23,51,36,87,edad 20
06616,Pellegrini,24,38,40,78,edad 20
06616,Pellegrini,25,43,39,82,edad 20
06616,Pellegrini,26,37,41,78,edad 20
06616,Pellegrini,27,36,33,69,edad 20
06616,Pellegrini,28,36,31,67,edad 20
06616,Pellegrini,29,43,45,88,edad 20
06616,Pellegrini,30,48,43,91,edad 30
06616,Pellegrini,31,37,46,83,edad 30
06616,Pellegrini,32,31,39,70,edad 30
06616,Pellegrini,33,36,33,69,edad 30
06616,Pellegrini,34,38,38,76,edad 30
06616,Pellegrini,35,43,35,78,edad 30
06616,Pellegrini,36,34,29,63,edad 30
06616,Pellegrini,37,33,38,71,edad 30
06616,Pellegrini,38,47,45,92,edad 30
06616,Pellegrini,39,42,50,92,edad 30
06616,Pellegrini,40,48,34,82,edad 40
06616,Pellegrini,41,41,32,73,edad 40
06616,Pellegrini,42,44,40,84,edad 40
06616,Pellegrini,43,52,32,84,edad 40
06616,Pellegrini,44,29,33,62,edad 40
06616,Pellegrini,45,29,33,62,edad 40
06616,Pellegrini,46,37,35,72,edad 40
06616,Pellegrini,47,20,31,51,edad 40
06616,Pellegrini,48,31,27,58,edad 40
06616,Pellegrini,49,37,36,73,edad 40
06616,Pellegrini,50,41,24,65,edad 50
06616,Pellegrini,51,36,34,70,edad 50
06616,Pellegrini,52,36,41,77,edad 50
06616,Pellegrini,53,41,30,71,edad 50
06616,Pellegrini,54,32,33,65,edad 50
06616,Pellegrini,55,40,32,72,edad 50
06616,Pellegrini,56,29,43,72,edad 50
06616,Pellegrini,57,21,22,43,edad 50
06616,Pellegrini,58,34,33,67,edad 50
06616,Pellegrini,59,27,26,53,edad 50
06616,Pellegrini,60,36,22,58,edad 60
06616,Pellegrini,61,29,25,54,edad 60
06616,Pellegrini,62,26,19,45,edad 60
06616,Pellegrini,63,32,27,59,edad 60
06616,Pellegrini,64,18,29,47,edad 60
06616,Pellegrini,65,32,29,61,edad 60
06616,Pellegrini,66,24,18,42,edad 60
06616,Pellegrini,67,14,27,41,edad 60
06616,Pellegrini,68,23,21,44,edad 60
06616,Pellegrini,69,20,10,30,edad 60
06616,Pellegrini,70,26,22,48,edad 70
06616,Pellegrini,71,13,23,36,edad 70
06616,Pellegrini,72,16,27,43,edad 70
06616,Pellegrini,73,13,23,36,edad 70
06616,Pellegrini,74,12,15,27,edad 70
06616,Pellegrini,75,16,16,32,edad 70
06616,Pellegrini,76,8,16,24,edad 70
06616,Pellegrini,77,15,16,31,edad 70
06616,Pellegrini,78,9,17,26,edad 70
06616,Pellegrini,79,7,12,19,edad 70
06616,Pellegrini,80,14,13,27,edad 80
06616,Pellegrini,81,8,5,13,edad 80
06616,Pellegrini,82,12,10,22,edad 80
06616,Pellegrini,83,5,17,22,edad 80
06616,Pellegrini,84,5,12,17,edad 80
06616,Pellegrini,85,4,8,12,edad 80
06616,Pellegrini,86,12,14,26,edad 80
06616,Pellegrini,87,4,8,12,edad 80
06616,Pellegrini,88,5,10,15,edad 80
06616,Pellegrini,89,2,7,9,edad 80
06616,Pellegrini,90,2,7,9,edad 90
06616,Pellegrini,91,0,2,2,edad 90
06616,Pellegrini,92,0,5,5,edad 90
06616,Pellegrini,93,3,2,5,edad 90
06616,Pellegrini,96,0,1,1,edad 90
06623,Pergamino,0,810,692,1502,edad 0
06623,Pergamino,1,679,674,1353,edad 0
06623,Pergamino,2,766,742,1508,edad 0
06623,Pergamino,3,749,706,1455,edad 0
06623,Pergamino,4,803,740,1543,edad 0
06623,Pergamino,5,825,795,1620,edad 0
06623,Pergamino,6,813,789,1602,edad 0
06623,Pergamino,7,836,801,1637,edad 0
06623,Pergamino,8,844,822,1666,edad 0
06623,Pergamino,9,861,846,1707,edad 0
06623,Pergamino,10,954,914,1868,edad 10
06623,Pergamino,11,866,900,1766,edad 10
06623,Pergamino,12,893,863,1756,edad 10
06623,Pergamino,13,885,867,1752,edad 10
06623,Pergamino,14,876,864,1740,edad 10
06623,Pergamino,15,884,914,1798,edad 10
06623,Pergamino,16,869,868,1737,edad 10
06623,Pergamino,17,903,832,1735,edad 10
06623,Pergamino,18,800,832,1632,edad 10
06623,Pergamino,19,839,820,1659,edad 10
06623,Pergamino,20,720,725,1445,edad 20
06623,Pergamino,21,753,700,1453,edad 20
06623,Pergamino,22,718,705,1423,edad 20
06623,Pergamino,23,694,710,1404,edad 20
06623,Pergamino,24,713,715,1428,edad 20
06623,Pergamino,25,687,701,1388,edad 20
06623,Pergamino,26,625,670,1295,edad 20
06623,Pergamino,27,630,637,1267,edad 20
06623,Pergamino,28,624,574,1198,edad 20
06623,Pergamino,29,604,608,1212,edad 20
06623,Pergamino,30,631,633,1264,edad 30
06623,Pergamino,31,584,649,1233,edad 30
06623,Pergamino,32,597,611,1208,edad 30
06623,Pergamino,33,560,624,1184,edad 30
06623,Pergamino,34,566,593,1159,edad 30
06623,Pergamino,35,537,630,1167,edad 30
06623,Pergamino,36,599,623,1222,edad 30
06623,Pergamino,37,615,664,1279,edad 30
06623,Pergamino,38,585,714,1299,edad 30
06623,Pergamino,39,595,636,1231,edad 30
06623,Pergamino,40,621,649,1270,edad 40
06623,Pergamino,41,565,625,1190,edad 40
06623,Pergamino,42,599,663,1262,edad 40
06623,Pergamino,43,579,606,1185,edad 40
06623,Pergamino,44,559,594,1153,edad 40
06623,Pergamino,45,545,619,1164,edad 40
06623,Pergamino,46,562,584,1146,edad 40
06623,Pergamino,47,552,579,1131,edad 40
06623,Pergamino,48,550,596,1146,edad 40
06623,Pergamino,49,519,546,1065,edad 40
06623,Pergamino,50,603,623,1226,edad 50
06623,Pergamino,51,526,616,1142,edad 50
06623,Pergamino,52,502,618,1120,edad 50
06623,Pergamino,53,564,531,1095,edad 50
06623,Pergamino,54,469,561,1030,edad 50
06623,Pergamino,55,483,554,1037,edad 50
06623,Pergamino,56,557,565,1122,edad 50
06623,Pergamino,57,454,487,941,edad 50
06623,Pergamino,58,437,492,929,edad 50
06623,Pergamino,59,398,459,857,edad 50
06623,Pergamino,60,444,473,917,edad 60
06623,Pergamino,61,425,488,913,edad 60
06623,Pergamino,62,430,496,926,edad 60
06623,Pergamino,63,418,509,927,edad 60
06623,Pergamino,64,407,453,860,edad 60
06623,Pergamino,65,393,476,869,edad 60
06623,Pergamino,66,325,445,770,edad 60
06623,Pergamino,67,361,408,769,edad 60
06623,Pergamino,68,347,456,803,edad 60
06623,Pergamino,69,364,425,789,edad 60
06623,Pergamino,70,345,481,826,edad 70
06623,Pergamino,71,343,438,781,edad 70
06623,Pergamino,72,313,439,752,edad 70
06623,Pergamino,73,307,402,709,edad 70
06623,Pergamino,74,304,380,684,edad 70
06623,Pergamino,75,259,397,656,edad 70
06623,Pergamino,76,239,399,638,edad 70
06623,Pergamino,77,189,314,503,edad 70
06623,Pergamino,78,214,300,514,edad 70
06623,Pergamino,79,174,277,451,edad 70
06623,Pergamino,80,160,314,474,edad 80
06623,Pergamino,81,137,240,377,edad 80
06623,Pergamino,82,122,234,356,edad 80
06623,Pergamino,83,100,184,284,edad 80
06623,Pergamino,84,80,187,267,edad 80
06623,Pergamino,85,79,181,260,edad 80
06623,Pergamino,86,87,152,239,edad 80
06623,Pergamino,87,66,130,196,edad 80
06623,Pergamino,88,55,110,165,edad 80
06623,Pergamino,89,38,79,117,edad 80
06623,Pergamino,90,22,72,94,edad 90
06623,Pergamino,91,21,77,98,edad 90
06623,Pergamino,92,18,53,71,edad 90
06623,Pergamino,93,12,25,37,edad 90
06623,Pergamino,94,3,31,34,edad 90
06623,Pergamino,95,5,20,25,edad 90
06623,Pergamino,96,7,6,13,edad 90
06623,Pergamino,97,2,6,8,edad 90
06623,Pergamino,98,2,4,6,edad 90
06623,Pergamino,99,2,3,5,edad 90
06630,Pila,0,31,28,59,edad 0
06630,Pila,1,33,18,51,edad 0
06630,Pila,2,32,25,57,edad 0
06630,Pila,3,31,30,61,edad 0
06630,Pila,4,36,21,57,edad 0
06630,Pila,5,24,31,55,edad 0
06630,Pila,6,39,35,74,edad 0
06630,Pila,7,30,24,54,edad 0
06630,Pila,8,25,36,61,edad 0
06630,Pila,9,33,40,73,edad 0
06630,Pila,10,21,38,59,edad 10
06630,Pila,11,33,36,69,edad 10
06630,Pila,12,30,20,50,edad 10
06630,Pila,13,29,28,57,edad 10
06630,Pila,14,26,33,59,edad 10
06630,Pila,15,37,27,64,edad 10
06630,Pila,16,22,33,55,edad 10
06630,Pila,17,26,38,64,edad 10
06630,Pila,18,29,25,54,edad 10
06630,Pila,19,35,19,54,edad 10
06630,Pila,20,24,22,46,edad 20
06630,Pila,21,23,23,46,edad 20
06630,Pila,22,23,19,42,edad 20
06630,Pila,23,22,25,47,edad 20
06630,Pila,24,21,27,48,edad 20
06630,Pila,25,27,18,45,edad 20
06630,Pila,26,20,15,35,edad 20
06630,Pila,27,23,16,39,edad 20
06630,Pila,28,23,22,45,edad 20
06630,Pila,29,25,21,46,edad 20
06630,Pila,30,20,22,42,edad 30
06630,Pila,31,26,23,49,edad 30
06630,Pila,32,16,25,41,edad 30
06630,Pila,33,23,21,44,edad 30
06630,Pila,34,16,22,38,edad 30
06630,Pila,35,31,23,54,edad 30
06630,Pila,36,27,12,39,edad 30
06630,Pila,37,9,19,28,edad 30
06630,Pila,38,20,20,40,edad 30
06630,Pila,39,28,17,45,edad 30
06630,Pila,40,29,17,46,edad 40
06630,Pila,41,14,23,37,edad 40
06630,Pila,42,22,24,46,edad 40
06630,Pila,43,19,11,30,edad 40
06630,Pila,44,15,26,41,edad 40
06630,Pila,45,26,19,45,edad 40
06630,Pila,46,20,15,35,edad 40
06630,Pila,47,22,22,44,edad 40
06630,Pila,48,23,16,39,edad 40
06630,Pila,49,15,17,32,edad 40
06630,Pila,50,23,25,48,edad 50
06630,Pila,51,18,15,33,edad 50
06630,Pila,52,24,19,43,edad 50
06630,Pila,53,25,20,45,edad 50
06630,Pila,54,11,14,25,edad 50
06630,Pila,55,18,16,34,edad 50
06630,Pila,56,19,13,32,edad 50
06630,Pila,57,19,13,32,edad 50
06630,Pila,58,22,14,36,edad 50
06630,Pila,59,21,16,37,edad 50
06630,Pila,60,12,14,26,edad 60
06630,Pila,61,18,15,33,edad 60
06630,Pila,62,15,16,31,edad 60
06630,Pila,63,8,7,15,edad 60
06630,Pila,64,15,9,24,edad 60
06630,Pila,65,15,14,29,edad 60
06630,Pila,66,15,13,28,edad 60
06630,Pila,67,15,10,25,edad 60
06630,Pila,68,15,7,22,edad 60
06630,Pila,69,11,13,24,edad 60
06630,Pila,70,11,15,26,edad 70
06630,Pila,71,7,12,19,edad 70
06630,Pila,72,5,16,21,edad 70
06630,Pila,73,10,9,19,edad 70
06630,Pila,74,13,6,19,edad 70
06630,Pila,75,10,8,18,edad 70
06630,Pila,76,6,10,16,edad 70
06630,Pila,77,9,6,15,edad 70
06630,Pila,78,9,6,15,edad 70
06630,Pila,79,5,4,9,edad 70
06630,Pila,80,10,7,17,edad 80
06630,Pila,81,6,4,10,edad 80
06630,Pila,82,2,3,5,edad 80
06630,Pila,83,1,4,5,edad 80
06630,Pila,84,1,1,2,edad 80
06630,Pila,85,5,5,10,edad 80
06630,Pila,86,4,1,5,edad 80
06630,Pila,87,0,1,1,edad 80
06630,Pila,88,3,2,5,edad 80
06630,Pila,89,2,3,5,edad 80
06630,Pila,90,0,3,3,edad 90
06630,Pila,91,0,2,2,edad 90
06630,Pila,92,1,3,4,edad 90
06630,Pila,94,0,2,2,edad 90
06630,Pila,96,0,1,1,edad 90
06630,Pila,98,1,0,1,edad 90
06638,Pilar,0,2721,2603,5324,edad 0
06638,Pilar,1,2582,2464,5046,edad 0
06638,Pilar,2,2908,2807,5715,edad 0
06638,Pilar,3,2777,2759,5536,edad 0
06638,Pilar,4,2886,2702,5588,edad 0
06638,Pilar,5,2922,2871,5793,edad 0
06638,Pilar,6,2833,2669,5502,edad 0
06638,Pilar,7,2749,2616,5365,edad 0
06638,Pilar,8,2675,2535,5210,edad 0
06638,Pilar,9,2553,2567,5120,edad 0
06638,Pilar,10,2751,2738,5489,edad 10
06638,Pilar,11,2553,2485,5038,edad 10
06638,Pilar,12,2563,2313,4876,edad 10
06638,Pilar,13,2373,2276,4649,edad 10
06638,Pilar,14,2400,2268,4668,edad 10
06638,Pilar,15,2206,2197,4403,edad 10
06638,Pilar,16,2119,2045,4164,edad 10
06638,Pilar,17,2033,1989,4022,edad 10
06638,Pilar,18,2018,1966,3984,edad 10
06638,Pilar,19,2107,2052,4159,edad 10
06638,Pilar,20,2005,2019,4024,edad 20
06638,Pilar,21,2071,2091,4162,edad 20
06638,Pilar,22,1963,2127,4090,edad 20
06638,Pilar,23,1971,2009,3980,edad 20
06638,Pilar,24,1911,1963,3874,edad 20
06638,Pilar,25,1821,1884,3705,edad 20
06638,Pilar,26,1699,1829,3528,edad 20
06638,Pilar,27,1673,1769,3442,edad 20
06638,Pilar,28,1812,1827,3639,edad 20
06638,Pilar,29,1607,1738,3345,edad 20
06638,Pilar,30,1796,2066,3862,edad 30
06638,Pilar,31,1664,1805,3469,edad 30
06638,Pilar,32,1669,1744,3413,edad 30
06638,Pilar,33,1621,1737,3358,edad 30
06638,Pilar,34,1531,1668,3199,edad 30
06638,Pilar,35,1609,1672,3281,edad 30
06638,Pilar,36,1613,1680,3293,edad 30
06638,Pilar,37,1510,1666,3176,edad 30
06638,Pilar,38,1680,1681,3361,edad 30
06638,Pilar,39,1522,1497,3019,edad 30
06638,Pilar,40,1563,1555,3118,edad 40
06638,Pilar,41,1446,1391,2837,edad 40
06638,Pilar,42,1506,1398,2904,edad 40
06638,Pilar,43,1453,1311,2764,edad 40
06638,Pilar,44,1225,1169,2394,edad 40
06638,Pilar,45,1339,1230,2569,edad 40
06638,Pilar,46,1195,1161,2356,edad 40
06638,Pilar,47,1188,1077,2265,edad 40
06638,Pilar,48,1148,1084,2232,edad 40
06638,Pilar,49,1089,1011,2100,edad 40
06638,Pilar,50,1144,1138,2282,edad 50
06638,Pilar,51,1061,987,2048,edad 50
06638,Pilar,52,993,1057,2050,edad 50
06638,Pilar,53,985,951,1936,edad 50
06638,Pilar,54,953,895,1848,edad 50
06638,Pilar,55,824,857,1681,edad 50
06638,Pilar,56,938,867,1805,edad 50
06638,Pilar,57,778,779,1557,edad 50
06638,Pilar,58,732,706,1438,edad 50
06638,Pilar,59,599,616,1215,edad 50
06638,Pilar,60,668,669,1337,edad 60
06638,Pilar,61,618,577,1195,edad 60
06638,Pilar,62,551,631,1182,edad 60
06638,Pilar,63,514,540,1054,edad 60
06638,Pilar,64,505,503,1008,edad 60
06638,Pilar,65,516,574,1090,edad 60
06638,Pilar,66,462,444,906,edad 60
06638,Pilar,67,402,402,804,edad 60
06638,Pilar,68,373,439,812,edad 60
06638,Pilar,69,396,397,793,edad 60
06638,Pilar,70,374,468,842,edad 70
06638,Pilar,71,368,394,762,edad 70
06638,Pilar,72,335,362,697,edad 70
06638,Pilar,73,288,358,646,edad 70
06638,Pilar,74,246,354,600,edad 70
06638,Pilar,75,248,323,571,edad 70
06638,Pilar,76,241,310,551,edad 70
06638,Pilar,77,204,257,461,edad 70
06638,Pilar,78,162,275,437,edad 70
06638,Pilar,79,145,209,354,edad 70
06638,Pilar,80,115,206,321,edad 80
06638,Pilar,81,119,167,286,edad 80
06638,Pilar,82,79,181,260,edad 80
06638,Pilar,83,58,110,168,edad 80
06638,Pilar,84,60,128,188,edad 80
06638,Pilar,85,58,110,168,edad 80
06638,Pilar,86,42,95,137,edad 80
06638,Pilar,87,34,88,122,edad 80
06638,Pilar,88,35,63,98,edad 80
06638,Pilar,89,27,59,86,edad 80
06638,Pilar,90,19,51,70,edad 90
06638,Pilar,91,12,26,38,edad 90
06638,Pilar,92,13,29,42,edad 90
06638,Pilar,93,10,29,39,edad 90
06638,Pilar,94,3,15,18,edad 90
06638,Pilar,95,0,8,8,edad 90
06638,Pilar,96,8,13,21,edad 90
06638,Pilar,97,0,4,4,edad 90
06638,Pilar,98,2,3,5,edad 90
06638,Pilar,99,3,4,7,edad 90
06644,Pinamar,0,204,196,400,edad 0
06644,Pinamar,1,163,212,375,edad 0
06644,Pinamar,2,202,184,386,edad 0
06644,Pinamar,3,183,172,355,edad 0
06644,Pinamar,4,212,193,405,edad 0
06644,Pinamar,5,183,213,396,edad 0
06644,Pinamar,6,177,159,336,edad 0
06644,Pinamar,7,158,191,349,edad 0
06644,Pinamar,8,168,167,335,edad 0
06644,Pinamar,9,169,172,341,edad 0
06644,Pinamar,10,193,193,386,edad 10
06644,Pinamar,11,182,179,361,edad 10
06644,Pinamar,12,188,185,373,edad 10
06644,Pinamar,13,212,175,387,edad 10
06644,Pinamar,14,189,183,372,edad 10
06644,Pinamar,15,174,168,342,edad 10
06644,Pinamar,16,171,141,312,edad 10
06644,Pinamar,17,166,129,295,edad 10
06644,Pinamar,18,170,146,316,edad 10
06644,Pinamar,19,142,149,291,edad 10
06644,Pinamar,20,152,138,290,edad 20
06644,Pinamar,21,150,163,313,edad 20
06644,Pinamar,22,163,149,312,edad 20
06644,Pinamar,23,163,177,340,edad 20
06644,Pinamar,24,161,138,299,edad 20
06644,Pinamar,25,153,161,314,edad 20
06644,Pinamar,26,123,166,289,edad 20
06644,Pinamar,27,151,162,313,edad 20
06644,Pinamar,28,174,172,346,edad 20
06644,Pinamar,29,132,188,320,edad 20
06644,Pinamar,30,193,191,384,edad 30
06644,Pinamar,31,134,167,301,edad 30
06644,Pinamar,32,137,166,303,edad 30
06644,Pinamar,33,154,170,324,edad 30
06644,Pinamar,34,138,145,283,edad 30
06644,Pinamar,35,152,160,312,edad 30
06644,Pinamar,36,156,159,315,edad 30
06644,Pinamar,37,140,163,303,edad 30
06644,Pinamar,38,187,157,344,edad 30
06644,Pinamar,39,150,170,320,edad 30
06644,Pinamar,40,136,160,296,edad 40
06644,Pinamar,41,137,146,283,edad 40
06644,Pinamar,42,161,143,304,edad 40
06644,Pinamar,43,140,123,263,edad 40
06644,Pinamar,44,128,141,269,edad 40
06644,Pinamar,45,136,127,263,edad 40
06644,Pinamar,46,129,123,252,edad 40
06644,Pinamar,47,141,125,266,edad 40
06644,Pinamar,48,117,135,252,edad 40
06644,Pinamar,49,112,127,239,edad 40
06644,Pinamar,50,133,147,280,edad 50
06644,Pinamar,51,124,105,229,edad 50
06644,Pinamar,52,132,107,239,edad 50
06644,Pinamar,53,117,106,223,edad 50
06644,Pinamar,54,115,91,206,edad 50
06644,Pinamar,55,98,92,190,edad 50
06644,Pinamar,56,104,105,209,edad 50
06644,Pinamar,57,85,95,180,edad 50
06644,Pinamar,58,81,110,191,edad 50
06644,Pinamar,59,66,69,135,edad 50
06644,Pinamar,60,91,89,180,edad 60
06644,Pinamar,61,88,84,172,edad 60
06644,Pinamar,62,80,85,165,edad 60
06644,Pinamar,63,80,85,165,edad 60
06644,Pinamar,64,91,75,166,edad 60
06644,Pinamar,65,59,83,142,edad 60
06644,Pinamar,66,65,75,140,edad 60
06644,Pinamar,67,55,57,112,edad 60
06644,Pinamar,68,51,55,106,edad 60
06644,Pinamar,69,46,59,105,edad 60
06644,Pinamar,70,52,55,107,edad 70
06644,Pinamar,71,55,43,98,edad 70
06644,Pinamar,72,46,44,90,edad 70
06644,Pinamar,73,45,47,92,edad 70
06644,Pinamar,74,42,48,90,edad 70
06644,Pinamar,75,43,31,74,edad 70
06644,Pinamar,76,33,36,69,edad 70
06644,Pinamar,77,27,32,59,edad 70
06644,Pinamar,78,20,32,52,edad 70
06644,Pinamar,79,24,22,46,edad 70
06644,Pinamar,80,14,23,37,edad 80
06644,Pinamar,81,17,20,37,edad 80
06644,Pinamar,82,14,16,30,edad 80
06644,Pinamar,83,7,14,21,edad 80
06644,Pinamar,84,6,10,16,edad 80
06644,Pinamar,85,8,6,14,edad 80
06644,Pinamar,86,5,3,8,edad 80
06644,Pinamar,87,8,8,16,edad 80
06644,Pinamar,88,4,7,11,edad 80
06644,Pinamar,89,5,8,13,edad 80
06644,Pinamar,90,1,8,9,edad 90
06644,Pinamar,91,2,3,5,edad 90
06644,Pinamar,92,0,3,3,edad 90
06644,Pinamar,93,1,2,3,edad 90
06644,Pinamar,94,0,3,3,edad 90
06644,Pinamar,95,0,2,2,edad 90
06644,Pinamar,96,0,1,1,edad 90
06648,Presidente Perón,0,723,718,1441,edad 0
06648,Presidente Perón,1,669,702,1371,edad 0
06648,Presidente Perón,2,738,766,1504,edad 0
06648,Presidente Perón,3,738,678,1416,edad 0
06648,Presidente Perón,4,776,694,1470,edad 0
06648,Presidente Perón,5,781,769,1550,edad 0
06648,Presidente Perón,6,747,750,1497,edad 0
06648,Presidente Perón,7,731,687,1418,edad 0
06648,Presidente Perón,8,732,713,1445,edad 0
06648,Presidente Perón,9,677,724,1401,edad 0
06648,Presidente Perón,10,773,678,1451,edad 10
06648,Presidente Perón,11,658,681,1339,edad 10
06648,Presidente Perón,12,639,664,1303,edad 10
06648,Presidente Perón,13,671,633,1304,edad 10
06648,Presidente Perón,14,668,646,1314,edad 10
06648,Presidente Perón,15,608,606,1214,edad 10
06648,Presidente Perón,16,622,572,1194,edad 10
06648,Presidente Perón,17,598,575,1173,edad 10
06648,Presidente Perón,18,546,530,1076,edad 10
06648,Presidente Perón,19,626,612,1238,edad 10
06648,Presidente Perón,20,564,549,1113,edad 20
06648,Presidente Perón,21,566,628,1194,edad 20
06648,Presidente Perón,22,538,533,1071,edad 20
06648,Presidente Perón,23,557,575,1132,edad 20
06648,Presidente Perón,24,557,508,1065,edad 20
06648,Presidente Perón,25,518,484,1002,edad 20
06648,Presidente Perón,26,441,510,951,edad 20
06648,Presidente Perón,27,443,488,931,edad 20
06648,Presidente Perón,28,436,439,875,edad 20
06648,Presidente Perón,29,433,449,882,edad 20
06648,Presidente Perón,30,460,470,930,edad 30
06648,Presidente Perón,31,423,421,844,edad 30
06648,Presidente Perón,32,369,377,746,edad 30
06648,Presidente Perón,33,346,389,735,edad 30
06648,Presidente Perón,34,350,339,689,edad 30
06648,Presidente Perón,35,342,368,710,edad 30
06648,Presidente Perón,36,347,376,723,edad 30
06648,Presidente Perón,37,351,379,730,edad 30
06648,Presidente Perón,38,378,367,745,edad 30
06648,Presidente Perón,39,287,352,639,edad 30
06648,Presidente Perón,40,333,375,708,edad 40
06648,Presidente Perón,41,352,341,693,edad 40
06648,Presidente Perón,42,405,347,752,edad 40
06648,Presidente Perón,43,328,326,654,edad 40
06648,Presidente Perón,44,307,316,623,edad 40
06648,Presidente Perón,45,316,305,621,edad 40
06648,Presidente Perón,46,305,291,596,edad 40
06648,Presidente Perón,47,300,273,573,edad 40
06648,Presidente Perón,48,290,290,580,edad 40
06648,Presidente Perón,49,283,268,551,edad 40
06648,Presidente Perón,50,301,299,600,edad 50
06648,Presidente Perón,51,265,262,527,edad 50
06648,Presidente Perón,52,267,238,505,edad 50
06648,Presidente Perón,53,242,240,482,edad 50
06648,Presidente Perón,54,207,197,404,edad 50
06648,Presidente Perón,55,222,179,401,edad 50
06648,Presidente Perón,56,230,206,436,edad 50
06648,Presidente Perón,57,170,206,376,edad 50
06648,Presidente Perón,58,175,188,363,edad 50
06648,Presidente Perón,59,168,151,319,edad 50
06648,Presidente Perón,60,156,163,319,edad 60
06648,Presidente Perón,61,149,136,285,edad 60
06648,Presidente Perón,62,138,140,278,edad 60
06648,Presidente Perón,63,149,136,285,edad 60
06648,Presidente Perón,64,102,155,257,edad 60
06648,Presidente Perón,65,110,140,250,edad 60
06648,Presidente Perón,66,98,131,229,edad 60
06648,Presidente Perón,67,103,117,220,edad 60
06648,Presidente Perón,68,92,114,206,edad 60
06648,Presidente Perón,69,79,93,172,edad 60
06648,Presidente Perón,70,115,124,239,edad 70
06648,Presidente Perón,71,91,101,192,edad 70
06648,Presidente Perón,72,83,112,195,edad 70
06648,Presidente Perón,73,59,93,152,edad 70
06648,Presidente Perón,74,61,91,152,edad 70
06648,Presidente Perón,75,56,94,150,edad 70
06648,Presidente Perón,76,61,106,167,edad 70
06648,Presidente Perón,77,49,65,114,edad 70
06648,Presidente Perón,78,38,84,122,edad 70
06648,Presidente Perón,79,32,63,95,edad 70
06648,Presidente Perón,80,25,42,67,edad 80
06648,Presidente Perón,81,28,46,74,edad 80
06648,Presidente Perón,82,22,40,62,edad 80
06648,Presidente Perón,83,25,29,54,edad 80
06648,Presidente Perón,84,9,26,35,edad 80
06648,Presidente Perón,85,9,26,35,edad 80
06648,Presidente Perón,86,19,33,52,edad 80
06648,Presidente Perón,87,8,21,29,edad 80
06648,Presidente Perón,88,10,22,32,edad 80
06648,Presidente Perón,89,5,17,22,edad 80
06648,Presidente Perón,90,2,9,11,edad 90
06648,Presidente Perón,91,2,10,12,edad 90
06648,Presidente Perón,92,2,9,11,edad 90
06648,Presidente Perón,93,3,4,7,edad 90
06648,Presidente Perón,94,0,4,4,edad 90
06648,Presidente Perón,95,1,2,3,edad 90
06648,Presidente Perón,96,2,2,4,edad 90
06648,Presidente Perón,97,0,1,1,edad 90
06648,Presidente Perón,98,0,2,2,edad 90
06648,Presidente Perón,99,0,3,3,edad 90
06651,Puán,0,110,94,204,edad 0
06651,Puán,1,98,80,178,edad 0
06651,Puán,2,98,84,182,edad 0
06651,Puán,3,98,82,180,edad 0
06651,Puán,4,112,114,226,edad 0
06651,Puán,5,115,112,227,edad 0
06651,Puán,6,102,121,223,edad 0
06651,Puán,7,91,98,189,edad 0
06651,Puán,8,120,125,245,edad 0
06651,Puán,9,128,105,233,edad 0
06651,Puán,10,145,130,275,edad 10
06651,Puán,11,137,126,263,edad 10
06651,Puán,12,140,116,256,edad 10
06651,Puán,13,137,128,265,edad 10
06651,Puán,14,136,133,269,edad 10
06651,Puán,15,148,132,280,edad 10
06651,Puán,16,137,140,277,edad 10
06651,Puán,17,138,127,265,edad 10
06651,Puán,18,109,95,204,edad 10
06651,Puán,19,110,84,194,edad 10
06651,Puán,20,112,89,201,edad 20
06651,Puán,21,92,89,181,edad 20
06651,Puán,22,98,86,184,edad 20
06651,Puán,23,71,92,163,edad 20
06651,Puán,24,90,99,189,edad 20
06651,Puán,25,82,79,161,edad 20
06651,Puán,26,95,76,171,edad 20
06651,Puán,27,72,92,164,edad 20
06651,Puán,28,104,91,195,edad 20
06651,Puán,29,92,91,183,edad 20
06651,Puán,30,106,95,201,edad 30
06651,Puán,31,100,96,196,edad 30
06651,Puán,32,90,89,179,edad 30
06651,Puán,33,90,108,198,edad 30
06651,Puán,34,93,91,184,edad 30
06651,Puán,35,109,98,207,edad 30
06651,Puán,36,103,111,214,edad 30
06651,Puán,37,122,90,212,edad 30
06651,Puán,38,101,132,233,edad 30
06651,Puán,39,108,115,223,edad 30
06651,Puán,40,117,133,250,edad 40
06651,Puán,41,112,105,217,edad 40
06651,Puán,42,90,101,191,edad 40
06651,Puán,43,107,103,210,edad 40
06651,Puán,44,93,87,180,edad 40
06651,Puán,45,126,96,222,edad 40
06651,Puán,46,102,91,193,edad 40
06651,Puán,47,94,106,200,edad 40
06651,Puán,48,99,90,189,edad 40
06651,Puán,49,96,105,201,edad 40
06651,Puán,50,107,99,206,edad 50
06651,Puán,51,96,107,203,edad 50
06651,Puán,52,100,96,196,edad 50
06651,Puán,53,119,112,231,edad 50
06651,Puán,54,107,90,197,edad 50
06651,Puán,55,118,106,224,edad 50
06651,Puán,56,105,117,222,edad 50
06651,Puán,57,79,95,174,edad 50
06651,Puán,58,79,88,167,edad 50
06651,Puán,59,95,111,206,edad 50
06651,Puán,60,100,93,193,edad 60
06651,Puán,61,106,89,195,edad 60
06651,Puán,62,79,92,171,edad 60
06651,Puán,63,95,103,198,edad 60
06651,Puán,64,81,86,167,edad 60
06651,Puán,65,100,93,193,edad 60
06651,Puán,66,83,107,190,edad 60
06651,Puán,67,84,83,167,edad 60
06651,Puán,68,78,85,163,edad 60
06651,Puán,69,88,90,178,edad 60
06651,Puán,70,82,105,187,edad 70
06651,Puán,71,77,77,154,edad 70
06651,Puán,72,78,78,156,edad 70
06651,Puán,73,81,72,153,edad 70
06651,Puán,74,74,81,155,edad 70
06651,Puán,75,68,81,149,edad 70
06651,Puán,76,55,70,125,edad 70
06651,Puán,77,54,82,136,edad 70
06651,Puán,78,44,48,92,edad 70
06651,Puán,79,34,47,81,edad 70
06651,Puán,80,41,44,85,edad 80
06651,Puán,81,29,40,69,edad 80
06651,Puán,82,18,53,71,edad 80
06651,Puán,83,24,49,73,edad 80
06651,Puán,84,15,39,54,edad 80
06651,Puán,85,20,38,58,edad 80
06651,Puán,86,16,25,41,edad 80
06651,Puán,87,8,28,36,edad 80
06651,Puán,88,18,23,41,edad 80
06651,Puán,89,9,17,26,edad 80
06651,Puán,90,6,16,22,edad 90
06651,Puán,91,6,13,19,edad 90
06651,Puán,92,3,6,9,edad 90
06651,Puán,93,5,6,11,edad 90
06651,Puán,95,0,2,2,edad 90
06651,Puán,96,1,1,2,edad 90
06651,Puán,97,0,1,1,edad 90
06651,Puán,98,0,1,1,edad 90
06651,Puán,99,1,0,1,edad 90
06655,Punta Indio,0,68,57,125,edad 0
06655,Punta Indio,1,69,72,141,edad 0
06655,Punta Indio,2,70,70,140,edad 0
06655,Punta Indio,3,84,80,164,edad 0
06655,Punta Indio,4,75,82,157,edad 0
06655,Punta Indio,5,73,78,151,edad 0
06655,Punta Indio,6,88,83,171,edad 0
06655,Punta Indio,7,80,82,162,edad 0
06655,Punta Indio,8,82,78,160,edad 0
06655,Punta Indio,9,77,80,157,edad 0
06655,Punta Indio,10,78,84,162,edad 10
06655,Punta Indio,11,81,81,162,edad 10
06655,Punta Indio,12,89,83,172,edad 10
06655,Punta Indio,13,71,59,130,edad 10
06655,Punta Indio,14,93,74,167,edad 10
06655,Punta Indio,15,72,65,137,edad 10
06655,Punta Indio,16,71,73,144,edad 10
06655,Punta Indio,17,81,71,152,edad 10
06655,Punta Indio,18,73,58,131,edad 10
06655,Punta Indio,19,67,78,145,edad 10
06655,Punta Indio,20,76,54,130,edad 20
06655,Punta Indio,21,84,70,154,edad 20
06655,Punta Indio,22,74,73,147,edad 20
06655,Punta Indio,23,65,70,135,edad 20
06655,Punta Indio,24,79,88,167,edad 20
06655,Punta Indio,25,62,61,123,edad 20
06655,Punta Indio,26,63,74,137,edad 20
06655,Punta Indio,27,60,72,132,edad 20
06655,Punta Indio,28,63,63,126,edad 20
06655,Punta Indio,29,61,60,121,edad 20
06655,Punta Indio,30,66,67,133,edad 30
06655,Punta Indio,31,72,52,124,edad 30
06655,Punta Indio,32,65,56,121,edad 30
06655,Punta Indio,33,55,67,122,edad 30
06655,Punta Indio,34,48,49,97,edad 30
06655,Punta Indio,35,59,41,100,edad 30
06655,Punta Indio,36,54,69,123,edad 30
06655,Punta Indio,37,52,45,97,edad 30
06655,Punta Indio,38,73,52,125,edad 30
06655,Punta Indio,39,47,60,107,edad 30
06655,Punta Indio,40,58,49,107,edad 40
06655,Punta Indio,41,57,51,108,edad 40
06655,Punta Indio,42,63,58,121,edad 40
06655,Punta Indio,43,50,55,105,edad 40
06655,Punta Indio,44,58,61,119,edad 40
06655,Punta Indio,45,51,57,108,edad 40
06655,Punta Indio,46,55,49,104,edad 40
06655,Punta Indio,47,45,45,90,edad 40
06655,Punta Indio,48,47,60,107,edad 40
06655,Punta Indio,49,63,44,107,edad 40
06655,Punta Indio,50,50,51,101,edad 50
06655,Punta Indio,51,62,52,114,edad 50
06655,Punta Indio,52,42,44,86,edad 50
06655,Punta Indio,53,60,58,118,edad 50
06655,Punta Indio,54,54,52,106,edad 50
06655,Punta Indio,55,46,47,93,edad 50
06655,Punta Indio,56,56,49,105,edad 50
06655,Punta Indio,57,42,52,94,edad 50
06655,Punta Indio,58,39,52,91,edad 50
06655,Punta Indio,59,51,38,89,edad 50
06655,Punta Indio,60,54,43,97,edad 60
06655,Punta Indio,61,52,46,98,edad 60
06655,Punta Indio,62,41,48,89,edad 60
06655,Punta Indio,63,47,48,95,edad 60
06655,Punta Indio,64,53,36,89,edad 60
06655,Punta Indio,65,48,40,88,edad 60
06655,Punta Indio,66,36,49,85,edad 60
06655,Punta Indio,67,35,50,85,edad 60
06655,Punta Indio,68,31,44,75,edad 60
06655,Punta Indio,69,38,40,78,edad 60
06655,Punta Indio,70,31,37,68,edad 70
06655,Punta Indio,71,43,31,74,edad 70
06655,Punta Indio,72,36,33,69,edad 70
06655,Punta Indio,73,31,40,71,edad 70
06655,Punta Indio,74,31,37,68,edad 70
06655,Punta Indio,75,38,34,72,edad 70
06655,Punta Indio,76,19,21,40,edad 70
06655,Punta Indio,77,19,26,45,edad 70
06655,Punta Indio,78,25,36,61,edad 70
06655,Punta Indio,79,24,16,40,edad 70
06655,Punta Indio,80,14,25,39,edad 80
06655,Punta Indio,81,14,15,29,edad 80
06655,Punta Indio,82,12,14,26,edad 80
06655,Punta Indio,83,12,17,29,edad 80
06655,Punta Indio,84,4,10,14,edad 80
06655,Punta Indio,85,12,6,18,edad 80
06655,Punta Indio,86,6,14,20,edad 80
06655,Punta Indio,87,9,4,13,edad 80
06655,Punta Indio,88,4,13,17,edad 80
06655,Punta Indio,89,3,8,11,edad 80
06655,Punta Indio,90,2,4,6,edad 90
06655,Punta Indio,91,1,8,9,edad 90
06655,Punta Indio,92,2,6,8,edad 90
06655,Punta Indio,93,2,0,2,edad 90
06655,Punta Indio,94,1,4,5,edad 90
06655,Punta Indio,95,0,2,2,edad 90
06655,Punta Indio,98,0,1,1,edad 90
06655,Punta Indio,99,1,0,1,edad 90
06665,Ramallo,0,247,237,484,edad 0
06665,Ramallo,1,215,243,458,edad 0
06665,Ramallo,2,265,245,510,edad 0
06665,Ramallo,3,242,235,477,edad 0
06665,Ramallo,4,259,241,500,edad 0
06665,Ramallo,5,295,267,562,edad 0
06665,Ramallo,6,274,280,554,edad 0
06665,Ramallo,7,268,254,522,edad 0
06665,Ramallo,8,287,276,563,edad 0
06665,Ramallo,9,286,294,580,edad 0
06665,Ramallo,10,294,289,583,edad 10
06665,Ramallo,11,277,259,536,edad 10
06665,Ramallo,12,263,271,534,edad 10
06665,Ramallo,13,248,241,489,edad 10
06665,Ramallo,14,253,256,509,edad 10
06665,Ramallo,15,274,264,538,edad 10
06665,Ramallo,16,262,245,507,edad 10
06665,Ramallo,17,253,283,536,edad 10
06665,Ramallo,18,252,237,489,edad 10
06665,Ramallo,19,257,247,504,edad 10
06665,Ramallo,20,284,248,532,edad 20
06665,Ramallo,21,276,250,526,edad 20
06665,Ramallo,22,237,265,502,edad 20
06665,Ramallo,23,227,252,479,edad 20
06665,Ramallo,24,215,215,430,edad 20
06665,Ramallo,25,220,225,445,edad 20
06665,Ramallo,26,238,191,429,edad 20
06665,Ramallo,27,215,188,403,edad 20
06665,Ramallo,28,217,207,424,edad 20
06665,Ramallo,29,182,199,381,edad 20
06665,Ramallo,30,178,194,372,edad 30
06665,Ramallo,31,184,191,375,edad 30
06665,Ramallo,32,165,177,342,edad 30
06665,Ramallo,33,181,192,373,edad 30
06665,Ramallo,34,171,174,345,edad 30
06665,Ramallo,35,177,166,343,edad 30
06665,Ramallo,36,206,163,369,edad 30
06665,Ramallo,37,174,184,358,edad 30
06665,Ramallo,38,191,187,378,edad 30
06665,Ramallo,39,165,163,328,edad 30
06665,Ramallo,40,161,169,330,edad 40
06665,Ramallo,41,151,161,312,edad 40
06665,Ramallo,42,175,175,350,edad 40
06665,Ramallo,43,162,178,340,edad 40
06665,Ramallo,44,157,171,328,edad 40
06665,Ramallo,45,155,176,331,edad 40
06665,Ramallo,46,163,150,313,edad 40
06665,Ramallo,47,140,174,314,edad 40
06665,Ramallo,48,193,158,351,edad 40
06665,Ramallo,49,161,161,322,edad 40
06665,Ramallo,50,150,180,330,edad 50
06665,Ramallo,51,163,143,306,edad 50
06665,Ramallo,52,172,122,294,edad 50
06665,Ramallo,53,159,125,284,edad 50
06665,Ramallo,54,147,142,289,edad 50
06665,Ramallo,55,115,156,271,edad 50
06665,Ramallo,56,158,149,307,edad 50
06665,Ramallo,57,126,125,251,edad 50
06665,Ramallo,58,117,132,249,edad 50
06665,Ramallo,59,117,118,235,edad 50
06665,Ramallo,60,127,133,260,edad 60
06665,Ramallo,61,120,127,247,edad 60
06665,Ramallo,62,117,100,217,edad 60
06665,Ramallo,63,107,125,232,edad 60
06665,Ramallo,64,120,96,216,edad 60
06665,Ramallo,65,122,115,237,edad 60
06665,Ramallo,66,119,107,226,edad 60
06665,Ramallo,67,109,92,201,edad 60
06665,Ramallo,68,102,111,213,edad 60
06665,Ramallo,69,90,116,206,edad 60
06665,Ramallo,70,101,108,209,edad 70
06665,Ramallo,71,91,99,190,edad 70
06665,Ramallo,72,91,98,189,edad 70
06665,Ramallo,73,79,90,169,edad 70
06665,Ramallo,74,74,101,175,edad 70
06665,Ramallo,75,71,89,160,edad 70
06665,Ramallo,76,55,84,139,edad 70
06665,Ramallo,77,50,58,108,edad 70
06665,Ramallo,78,46,60,106,edad 70
06665,Ramallo,79,48,61,109,edad 70
06665,Ramallo,80,38,55,93,edad 80
06665,Ramallo,81,32,61,93,edad 80
06665,Ramallo,82,28,37,65,edad 80
06665,Ramallo,83,30,44,74,edad 80
06665,Ramallo,84,17,32,49,edad 80
06665,Ramallo,85,21,30,51,edad 80
06665,Ramallo,86,18,40,58,edad 80
06665,Ramallo,87,21,30,51,edad 80
06665,Ramallo,88,9,29,38,edad 80
06665,Ramallo,89,10,23,33,edad 80
06665,Ramallo,90,8,20,28,edad 90
06665,Ramallo,91,4,17,21,edad 90
06665,Ramallo,92,5,7,12,edad 90
06665,Ramallo,93,2,10,12,edad 90
06665,Ramallo,94,1,4,5,edad 90
06665,Ramallo,95,1,6,7,edad 90
06665,Ramallo,96,2,1,3,edad 90
06665,Ramallo,97,0,1,1,edad 90
06672,Rauch,0,127,116,243,edad 0
06672,Rauch,1,115,104,219,edad 0
06672,Rauch,2,101,127,228,edad 0
06672,Rauch,3,108,122,230,edad 0
06672,Rauch,4,120,119,239,edad 0
06672,Rauch,5,125,115,240,edad 0
06672,Rauch,6,126,124,250,edad 0
06672,Rauch,7,144,100,244,edad 0
06672,Rauch,8,139,117,256,edad 0
06672,Rauch,9,138,123,261,edad 0
06672,Rauch,10,134,128,262,edad 10
06672,Rauch,11,144,141,285,edad 10
06672,Rauch,12,132,126,258,edad 10
06672,Rauch,13,130,118,248,edad 10
06672,Rauch,14,123,132,255,edad 10
06672,Rauch,15,142,131,273,edad 10
06672,Rauch,16,115,119,234,edad 10
06672,Rauch,17,112,112,224,edad 10
06672,Rauch,18,111,112,223,edad 10
06672,Rauch,19,110,111,221,edad 10
06672,Rauch,20,105,115,220,edad 20
06672,Rauch,21,111,84,195,edad 20
06672,Rauch,22,107,104,211,edad 20
06672,Rauch,23,81,105,186,edad 20
06672,Rauch,24,94,89,183,edad 20
06672,Rauch,25,100,94,194,edad 20
06672,Rauch,26,113,110,223,edad 20
06672,Rauch,27,92,98,190,edad 20
06672,Rauch,28,104,101,205,edad 20
06672,Rauch,29,83,97,180,edad 20
06672,Rauch,30,88,94,182,edad 30
06672,Rauch,31,65,72,137,edad 30
06672,Rauch,32,85,91,176,edad 30
06672,Rauch,33,88,76,164,edad 30
06672,Rauch,34,84,93,177,edad 30
06672,Rauch,35,71,85,156,edad 30
06672,Rauch,36,92,77,169,edad 30
06672,Rauch,37,97,96,193,edad 30
06672,Rauch,38,78,68,146,edad 30
06672,Rauch,39,74,76,150,edad 30
06672,Rauch,40,107,93,200,edad 40
06672,Rauch,41,82,90,172,edad 40
06672,Rauch,42,82,92,174,edad 40
06672,Rauch,43,86,86,172,edad 40
06672,Rauch,44,73,87,160,edad 40
06672,Rauch,45,93,93,186,edad 40
06672,Rauch,46,71,82,153,edad 40
06672,Rauch,47,94,74,168,edad 40
06672,Rauch,48,85,81,166,edad 40
06672,Rauch,49,70,71,141,edad 40
06672,Rauch,50,77,93,170,edad 50
06672,Rauch,51,86,87,173,edad 50
06672,Rauch,52,89,74,163,edad 50
06672,Rauch,53,90,82,172,edad 50
06672,Rauch,54,83,68,151,edad 50
06672,Rauch,55,82,80,162,edad 50
06672,Rauch,56,75,89,164,edad 50
06672,Rauch,57,75,79,154,edad 50
06672,Rauch,58,78,71,149,edad 50
06672,Rauch,59,71,74,145,edad 50
06672,Rauch,60,77,78,155,edad 60
06672,Rauch,61,73,64,137,edad 60
06672,Rauch,62,53,59,112,edad 60
06672,Rauch,63,69,63,132,edad 60
06672,Rauch,64,57,62,119,edad 60
06672,Rauch,65,56,61,117,edad 60
06672,Rauch,66,51,55,106,edad 60
06672,Rauch,67,54,62,116,edad 60
06672,Rauch,68,49,54,103,edad 60
06672,Rauch,69,53,50,103,edad 60
06672,Rauch,70,53,53,106,edad 70
06672,Rauch,71,46,49,95,edad 70
06672,Rauch,72,39,59,98,edad 70
06672,Rauch,73,34,51,85,edad 70
06672,Rauch,74,42,62,104,edad 70
06672,Rauch,75,45,48,93,edad 70
06672,Rauch,76,38,57,95,edad 70
06672,Rauch,77,33,55,88,edad 70
06672,Rauch,78,21,51,72,edad 70
06672,Rauch,79,32,42,74,edad 70
06672,Rauch,80,19,45,64,edad 80
06672,Rauch,81,18,35,53,edad 80
06672,Rauch,82,25,36,61,edad 80
06672,Rauch,83,6,27,33,edad 80
06672,Rauch,84,19,31,50,edad 80
06672,Rauch,85,14,36,50,edad 80
06672,Rauch,86,12,29,41,edad 80
06672,Rauch,87,11,20,31,edad 80
06672,Rauch,88,6,13,19,edad 80
06672,Rauch,89,7,13,20,edad 80
06672,Rauch,90,4,14,18,edad 90
06672,Rauch,91,2,14,16,edad 90
06672,Rauch,92,3,7,10,edad 90
06672,Rauch,93,6,3,9,edad 90
06672,Rauch,94,0,8,8,edad 90
06672,Rauch,95,1,4,5,edad 90
06672,Rauch,96,0,1,1,edad 90
06672,Rauch,97,1,2,3,edad 90
06672,Rauch,98,3,1,4,edad 90
06672,Rauch,99,1,1,2,edad 90
06679,Rivadavia,0,134,122,256,edad 0
06679,Rivadavia,1,125,133,258,edad 0
06679,Rivadavia,2,141,135,276,edad 0
06679,Rivadavia,3,149,131,280,edad 0
06679,Rivadavia,4,153,150,303,edad 0
06679,Rivadavia,5,144,135,279,edad 0
06679,Rivadavia,6,163,140,303,edad 0
06679,Rivadavia,7,155,162,317,edad 0
06679,Rivadavia,8,148,143,291,edad 0
06679,Rivadavia,9,155,156,311,edad 0
06679,Rivadavia,10,134,164,298,edad 10
06679,Rivadavia,11,192,143,335,edad 10
06679,Rivadavia,12,165,154,319,edad 10
06679,Rivadavia,13,135,144,279,edad 10
06679,Rivadavia,14,145,136,281,edad 10
06679,Rivadavia,15,128,144,272,edad 10
06679,Rivadavia,16,147,145,292,edad 10
06679,Rivadavia,17,134,138,272,edad 10
06679,Rivadavia,18,150,107,257,edad 10
06679,Rivadavia,19,111,90,201,edad 10
06679,Rivadavia,20,117,110,227,edad 20
06679,Rivadavia,21,104,77,181,edad 20
06679,Rivadavia,22,114,124,238,edad 20
06679,Rivadavia,23,97,99,196,edad 20
06679,Rivadavia,24,84,95,179,edad 20
06679,Rivadavia,25,105,91,196,edad 20
06679,Rivadavia,26,114,92,206,edad 20
06679,Rivadavia,27,94,103,197,edad 20
06679,Rivadavia,28,78,83,161,edad 20
06679,Rivadavia,29,112,100,212,edad 20
06679,Rivadavia,30,110,103,213,edad 30
06679,Rivadavia,31,83,91,174,edad 30
06679,Rivadavia,32,92,80,172,edad 30
06679,Rivadavia,33,97,101,198,edad 30
06679,Rivadavia,34,103,99,202,edad 30
06679,Rivadavia,35,86,106,192,edad 30
06679,Rivadavia,36,109,101,210,edad 30
06679,Rivadavia,37,103,105,208,edad 30
06679,Rivadavia,38,105,99,204,edad 30
06679,Rivadavia,39,108,93,201,edad 30
06679,Rivadavia,40,112,116,228,edad 40
06679,Rivadavia,41,94,104,198,edad 40
06679,Rivadavia,42,116,119,235,edad 40
06679,Rivadavia,43,109,95,204,edad 40
06679,Rivadavia,44,91,81,172,edad 40
06679,Rivadavia,45,107,98,205,edad 40
06679,Rivadavia,46,99,81,180,edad 40
06679,Rivadavia,47,92,86,178,edad 40
06679,Rivadavia,48,106,74,180,edad 40
06679,Rivadavia,49,77,80,157,edad 40
06679,Rivadavia,50,98,68,166,edad 50
06679,Rivadavia,51,81,72,153,edad 50
06679,Rivadavia,52,92,82,174,edad 50
06679,Rivadavia,53,70,80,150,edad 50
06679,Rivadavia,54,73,63,136,edad 50
06679,Rivadavia,55,75,90,165,edad 50
06679,Rivadavia,56,71,65,136,edad 50
06679,Rivadavia,57,81,70,151,edad 50
06679,Rivadavia,58,72,68,140,edad 50
06679,Rivadavia,59,69,66,135,edad 50
06679,Rivadavia,60,67,63,130,edad 60
06679,Rivadavia,61,58,44,102,edad 60
06679,Rivadavia,62,69,52,121,edad 60
06679,Rivadavia,63,58,57,115,edad 60
06679,Rivadavia,64,43,67,110,edad 60
06679,Rivadavia,65,78,59,137,edad 60
06679,Rivadavia,66,41,52,93,edad 60
06679,Rivadavia,67,52,57,109,edad 60
06679,Rivadavia,68,52,51,103,edad 60
06679,Rivadavia,69,46,42,88,edad 60
06679,Rivadavia,70,51,44,95,edad 70
06679,Rivadavia,71,47,40,87,edad 70
06679,Rivadavia,72,43,53,96,edad 70
06679,Rivadavia,73,47,61,108,edad 70
06679,Rivadavia,74,38,54,92,edad 70
06679,Rivadavia,75,41,49,90,edad 70
06679,Rivadavia,76,39,38,77,edad 70
06679,Rivadavia,77,36,39,75,edad 70
06679,Rivadavia,78,21,32,53,edad 70
06679,Rivadavia,79,26,43,69,edad 70
06679,Rivadavia,80,25,38,63,edad 80
06679,Rivadavia,81,13,28,41,edad 80
06679,Rivadavia,82,30,30,60,edad 80
06679,Rivadavia,83,16,30,46,edad 80
06679,Rivadavia,84,16,16,32,edad 80
06679,Rivadavia,85,6,19,25,edad 80
06679,Rivadavia,86,9,20,29,edad 80
06679,Rivadavia,87,7,20,27,edad 80
06679,Rivadavia,88,11,11,22,edad 80
06679,Rivadavia,89,4,10,14,edad 80
06679,Rivadavia,90,2,5,7,edad 90
06679,Rivadavia,91,4,11,15,edad 90
06679,Rivadavia,92,2,6,8,edad 90
06679,Rivadavia,93,5,2,7,edad 90
06679,Rivadavia,94,4,3,7,edad 90
06679,Rivadavia,95,1,3,4,edad 90
06679,Rivadavia,96,0,2,2,edad 90
06679,Rivadavia,97,0,1,1,edad 90
06679,Rivadavia,98,0,1,1,edad 90
06679,Rivadavia,99,1,0,1,edad 90
06686,Rojas,0,184,175,359,edad 0
06686,Rojas,1,155,136,291,edad 0
06686,Rojas,2,163,175,338,edad 0
06686,Rojas,3,179,185,364,edad 0
06686,Rojas,4,162,137,299,edad 0
06686,Rojas,5,155,179,334,edad 0
06686,Rojas,6,201,188,389,edad 0
06686,Rojas,7,175,181,356,edad 0
06686,Rojas,8,185,161,346,edad 0
06686,Rojas,9,174,190,364,edad 0
06686,Rojas,10,217,229,446,edad 10
06686,Rojas,11,199,198,397,edad 10
06686,Rojas,12,188,187,375,edad 10
06686,Rojas,13,199,171,370,edad 10
06686,Rojas,14,188,201,389,edad 10
06686,Rojas,15,179,177,356,edad 10
06686,Rojas,16,166,161,327,edad 10
06686,Rojas,17,174,163,337,edad 10
06686,Rojas,18,195,184,379,edad 10
06686,Rojas,19,171,193,364,edad 10
06686,Rojas,20,147,186,333,edad 20
06686,Rojas,21,140,176,316,edad 20
06686,Rojas,22,178,176,354,edad 20
06686,Rojas,23,170,162,332,edad 20
06686,Rojas,24,116,155,271,edad 20
06686,Rojas,25,146,126,272,edad 20
06686,Rojas,26,120,144,264,edad 20
06686,Rojas,27,151,122,273,edad 20
06686,Rojas,28,155,145,300,edad 20
06686,Rojas,29,107,141,248,edad 20
06686,Rojas,30,153,133,286,edad 30
06686,Rojas,31,134,139,273,edad 30
06686,Rojas,32,117,130,247,edad 30
06686,Rojas,33,116,166,282,edad 30
06686,Rojas,34,137,144,281,edad 30
06686,Rojas,35,132,137,269,edad 30
06686,Rojas,36,147,129,276,edad 30
06686,Rojas,37,129,133,262,edad 30
06686,Rojas,38,158,172,330,edad 30
06686,Rojas,39,117,140,257,edad 30
06686,Rojas,40,134,115,249,edad 40
06686,Rojas,41,127,124,251,edad 40
06686,Rojas,42,148,147,295,edad 40
06686,Rojas,43,117,116,233,edad 40
06686,Rojas,44,116,133,249,edad 40
06686,Rojas,45,131,140,271,edad 40
06686,Rojas,46,120,138,258,edad 40
06686,Rojas,47,134,121,255,edad 40
06686,Rojas,48,116,152,268,edad 40
06686,Rojas,49,126,121,247,edad 40
06686,Rojas,50,163,136,299,edad 50
06686,Rojas,51,122,161,283,edad 50
06686,Rojas,52,145,133,278,edad 50
06686,Rojas,53,122,135,257,edad 50
06686,Rojas,54,130,123,253,edad 50
06686,Rojas,55,122,103,225,edad 50
06686,Rojas,56,128,132,260,edad 50
06686,Rojas,57,113,120,233,edad 50
06686,Rojas,58,119,130,249,edad 50
06686,Rojas,59,99,104,203,edad 50
06686,Rojas,60,115,132,247,edad 60
06686,Rojas,61,98,108,206,edad 60
06686,Rojas,62,94,101,195,edad 60
06686,Rojas,63,118,109,227,edad 60
06686,Rojas,64,95,106,201,edad 60
06686,Rojas,65,98,117,215,edad 60
06686,Rojas,66,94,114,208,edad 60
06686,Rojas,67,97,105,202,edad 60
06686,Rojas,68,78,122,200,edad 60
06686,Rojas,69,94,119,213,edad 60
06686,Rojas,70,105,133,238,edad 70
06686,Rojas,71,92,103,195,edad 70
06686,Rojas,72,112,114,226,edad 70
06686,Rojas,73,85,122,207,edad 70
06686,Rojas,74,68,105,173,edad 70
06686,Rojas,75,94,79,173,edad 70
06686,Rojas,76,61,99,160,edad 70
06686,Rojas,77,73,88,161,edad 70
06686,Rojas,78,51,79,130,edad 70
06686,Rojas,79,50,75,125,edad 70
06686,Rojas,80,41,85,126,edad 80
06686,Rojas,81,36,63,99,edad 80
06686,Rojas,82,37,64,101,edad 80
06686,Rojas,83,34,54,88,edad 80
06686,Rojas,84,31,55,86,edad 80
06686,Rojas,85,28,55,83,edad 80
06686,Rojas,86,19,53,72,edad 80
06686,Rojas,87,25,32,57,edad 80
06686,Rojas,88,19,30,49,edad 80
06686,Rojas,89,17,25,42,edad 80
06686,Rojas,90,6,26,32,edad 90
06686,Rojas,91,6,16,22,edad 90
06686,Rojas,92,7,10,17,edad 90
06686,Rojas,93,3,11,14,edad 90
06686,Rojas,94,5,6,11,edad 90
06686,Rojas,95,3,4,7,edad 90
06686,Rojas,96,2,4,6,edad 90
06686,Rojas,97,1,2,3,edad 90
06686,Rojas,98,0,2,2,edad 90
06686,Rojas,99,0,1,1,edad 90
06693,Roque Pérez,0,95,98,193,edad 0
06693,Roque Pérez,1,85,95,180,edad 0
06693,Roque Pérez,2,101,87,188,edad 0
06693,Roque Pérez,3,95,91,186,edad 0
06693,Roque Pérez,4,89,86,175,edad 0
06693,Roque Pérez,5,100,73,173,edad 0
06693,Roque Pérez,6,73,95,168,edad 0
06693,Roque Pérez,7,79,89,168,edad 0
06693,Roque Pérez,8,98,83,181,edad 0
06693,Roque Pérez,9,90,95,185,edad 0
06693,Roque Pérez,10,82,89,171,edad 10
06693,Roque Pérez,11,77,87,164,edad 10
06693,Roque Pérez,12,89,80,169,edad 10
06693,Roque Pérez,13,110,89,199,edad 10
06693,Roque Pérez,14,94,81,175,edad 10
06693,Roque Pérez,15,83,90,173,edad 10
06693,Roque Pérez,16,78,83,161,edad 10
06693,Roque Pérez,17,100,90,190,edad 10
06693,Roque Pérez,18,70,77,147,edad 10
06693,Roque Pérez,19,87,96,183,edad 10
06693,Roque Pérez,20,80,61,141,edad 20
06693,Roque Pérez,21,91,88,179,edad 20
06693,Roque Pérez,22,79,80,159,edad 20
06693,Roque Pérez,23,80,76,156,edad 20
06693,Roque Pérez,24,76,79,155,edad 20
06693,Roque Pérez,25,83,67,150,edad 20
06693,Roque Pérez,26,80,72,152,edad 20
06693,Roque Pérez,27,80,68,148,edad 20
06693,Roque Pérez,28,62,78,140,edad 20
06693,Roque Pérez,29,69,68,137,edad 20
06693,Roque Pérez,30,77,70,147,edad 30
06693,Roque Pérez,31,61,60,121,edad 30
06693,Roque Pérez,32,67,81,148,edad 30
06693,Roque Pérez,33,68,66,134,edad 30
06693,Roque Pérez,34,60,60,120,edad 30
06693,Roque Pérez,35,63,62,125,edad 30
06693,Roque Pérez,36,61,61,122,edad 30
06693,Roque Pérez,37,53,63,116,edad 30
06693,Roque Pérez,38,63,76,139,edad 30
06693,Roque Pérez,39,57,59,116,edad 30
06693,Roque Pérez,40,81,59,140,edad 40
06693,Roque Pérez,41,61,65,126,edad 40
06693,Roque Pérez,42,62,60,122,edad 40
06693,Roque Pérez,43,71,70,141,edad 40
06693,Roque Pérez,44,84,76,160,edad 40
06693,Roque Pérez,45,70,57,127,edad 40
06693,Roque Pérez,46,67,64,131,edad 40
06693,Roque Pérez,47,54,60,114,edad 40
06693,Roque Pérez,48,56,59,115,edad 40
06693,Roque Pérez,49,57,68,125,edad 40
06693,Roque Pérez,50,71,71,142,edad 50
06693,Roque Pérez,51,51,45,96,edad 50
06693,Roque Pérez,52,68,64,132,edad 50
06693,Roque Pérez,53,71,70,141,edad 50
06693,Roque Pérez,54,59,78,137,edad 50
06693,Roque Pérez,55,55,54,109,edad 50
06693,Roque Pérez,56,71,53,124,edad 50
06693,Roque Pérez,57,59,46,105,edad 50
06693,Roque Pérez,58,50,47,97,edad 50
06693,Roque Pérez,59,47,52,99,edad 50
06693,Roque Pérez,60,46,62,108,edad 60
06693,Roque Pérez,61,44,64,108,edad 60
06693,Roque Pérez,62,51,61,112,edad 60
06693,Roque Pérez,63,56,46,102,edad 60
06693,Roque Pérez,64,44,45,89,edad 60
06693,Roque Pérez,65,54,44,98,edad 60
06693,Roque Pérez,66,45,60,105,edad 60
06693,Roque Pérez,67,46,51,97,edad 60
06693,Roque Pérez,68,44,45,89,edad 60
06693,Roque Pérez,69,44,55,99,edad 60
06693,Roque Pérez,70,51,47,98,edad 70
06693,Roque Pérez,71,35,51,86,edad 70
06693,Roque Pérez,72,42,54,96,edad 70
06693,Roque Pérez,73,37,35,72,edad 70
06693,Roque Pérez,74,43,44,87,edad 70
06693,Roque Pérez,75,33,45,78,edad 70
06693,Roque Pérez,76,33,34,67,edad 70
06693,Roque Pérez,77,32,40,72,edad 70
06693,Roque Pérez,78,20,38,58,edad 70
06693,Roque Pérez,79,14,30,44,edad 70
06693,Roque Pérez,80,17,32,49,edad 80
06693,Roque Pérez,81,16,20,36,edad 80
06693,Roque Pérez,82,20,23,43,edad 80
06693,Roque Pérez,83,14,18,32,edad 80
06693,Roque Pérez,84,15,21,36,edad 80
06693,Roque Pérez,85,9,13,22,edad 80
06693,Roque Pérez,86,7,12,19,edad 80
06693,Roque Pérez,87,2,14,16,edad 80
06693,Roque Pérez,88,4,11,15,edad 80
06693,Roque Pérez,89,4,11,15,edad 80
06693,Roque Pérez,90,2,12,14,edad 90
06693,Roque Pérez,91,3,2,5,edad 90
06693,Roque Pérez,92,1,6,7,edad 90
06693,Roque Pérez,93,1,0,1,edad 90
06693,Roque Pérez,94,3,0,3,edad 90
06693,Roque Pérez,95,0,4,4,edad 90
06693,Roque Pérez,96,0,2,2,edad 90
06700,Saavedra,0,137,144,281,edad 0
06700,Saavedra,1,135,138,273,edad 0
06700,Saavedra,2,145,136,281,edad 0
06700,Saavedra,3,142,142,284,edad 0
06700,Saavedra,4,160,136,296,edad 0
06700,Saavedra,5,123,150,273,edad 0
06700,Saavedra,6,144,124,268,edad 0
06700,Saavedra,7,149,156,305,edad 0
06700,Saavedra,8,154,126,280,edad 0
06700,Saavedra,9,164,154,318,edad 0
06700,Saavedra,10,172,191,363,edad 10
06700,Saavedra,11,173,162,335,edad 10
06700,Saavedra,12,166,162,328,edad 10
06700,Saavedra,13,187,175,362,edad 10
06700,Saavedra,14,187,188,375,edad 10
06700,Saavedra,15,158,170,328,edad 10
06700,Saavedra,16,200,164,364,edad 10
06700,Saavedra,17,181,166,347,edad 10
06700,Saavedra,18,144,134,278,edad 10
06700,Saavedra,19,152,129,281,edad 10
06700,Saavedra,20,130,126,256,edad 20
06700,Saavedra,21,175,141,316,edad 20
06700,Saavedra,22,172,130,302,edad 20
06700,Saavedra,23,146,122,268,edad 20
06700,Saavedra,24,116,132,248,edad 20
06700,Saavedra,25,133,130,263,edad 20
06700,Saavedra,26,115,111,226,edad 20
06700,Saavedra,27,112,110,222,edad 20
06700,Saavedra,28,123,128,251,edad 20
06700,Saavedra,29,114,121,235,edad 20
06700,Saavedra,30,112,119,231,edad 30
06700,Saavedra,31,125,133,258,edad 30
06700,Saavedra,32,110,117,227,edad 30
06700,Saavedra,33,120,120,240,edad 30
06700,Saavedra,34,121,119,240,edad 30
06700,Saavedra,35,128,132,260,edad 30
06700,Saavedra,36,120,133,253,edad 30
06700,Saavedra,37,129,123,252,edad 30
06700,Saavedra,38,125,137,262,edad 30
06700,Saavedra,39,133,133,266,edad 30
06700,Saavedra,40,143,160,303,edad 40
06700,Saavedra,41,144,111,255,edad 40
06700,Saavedra,42,132,144,276,edad 40
06700,Saavedra,43,121,121,242,edad 40
06700,Saavedra,44,110,115,225,edad 40
06700,Saavedra,45,112,116,228,edad 40
06700,Saavedra,46,114,133,247,edad 40
06700,Saavedra,47,115,101,216,edad 40
06700,Saavedra,48,106,103,209,edad 40
06700,Saavedra,49,116,104,220,edad 40
06700,Saavedra,50,114,124,238,edad 50
06700,Saavedra,51,116,118,234,edad 50
06700,Saavedra,52,126,135,261,edad 50
06700,Saavedra,53,102,107,209,edad 50
06700,Saavedra,54,98,132,230,edad 50
06700,Saavedra,55,102,92,194,edad 50
06700,Saavedra,56,108,104,212,edad 50
06700,Saavedra,57,103,119,222,edad 50
06700,Saavedra,58,95,95,190,edad 50
06700,Saavedra,59,73,95,168,edad 50
06700,Saavedra,60,97,83,180,edad 60
06700,Saavedra,61,95,83,178,edad 60
06700,Saavedra,62,98,115,213,edad 60
06700,Saavedra,63,74,99,173,edad 60
06700,Saavedra,64,86,96,182,edad 60
06700,Saavedra,65,78,104,182,edad 60
06700,Saavedra,66,61,90,151,edad 60
06700,Saavedra,67,84,76,160,edad 60
06700,Saavedra,68,69,85,154,edad 60
06700,Saavedra,69,81,96,177,edad 60
06700,Saavedra,70,74,91,165,edad 70
06700,Saavedra,71,75,92,167,edad 70
06700,Saavedra,72,75,88,163,edad 70
06700,Saavedra,73,68,87,155,edad 70
06700,Saavedra,74,70,86,156,edad 70
06700,Saavedra,75,62,60,122,edad 70
06700,Saavedra,76,55,75,130,edad 70
06700,Saavedra,77,37,79,116,edad 70
06700,Saavedra,78,42,74,116,edad 70
06700,Saavedra,79,40,61,101,edad 70
06700,Saavedra,80,38,68,106,edad 80
06700,Saavedra,81,34,53,87,edad 80
06700,Saavedra,82,15,47,62,edad 80
06700,Saavedra,83,23,60,83,edad 80
06700,Saavedra,84,22,39,61,edad 80
06700,Saavedra,85,18,35,53,edad 80
06700,Saavedra,86,13,36,49,edad 80
06700,Saavedra,87,14,30,44,edad 80
06700,Saavedra,88,6,28,34,edad 80
06700,Saavedra,89,6,19,25,edad 80
06700,Saavedra,90,9,19,28,edad 90
06700,Saavedra,91,4,15,19,edad 90
06700,Saavedra,92,4,11,15,edad 90
06700,Saavedra,93,3,8,11,edad 90
06700,Saavedra,94,1,5,6,edad 90
06700,Saavedra,95,1,7,8,edad 90
06700,Saavedra,97,0,1,1,edad 90
06700,Saavedra,98,2,0,2,edad 90
06700,Saavedra,99,1,2,3,edad 90
06707,Saladillo,0,232,225,457,edad 0
06707,Saladillo,1,236,188,424,edad 0
06707,Saladillo,2,261,229,490,edad 0
06707,Saladillo,3,241,228,469,edad 0
06707,Saladillo,4,224,235,459,edad 0
06707,Saladillo,5,283,230,513,edad 0
06707,Saladillo,6,228,260,488,edad 0
06707,Saladillo,7,254,194,448,edad 0
06707,Saladillo,8,252,238,490,edad 0
06707,Saladillo,9,263,254,517,edad 0
06707,Saladillo,10,250,267,517,edad 10
06707,Saladillo,11,245,268,513,edad 10
06707,Saladillo,12,277,178,455,edad 10
06707,Saladillo,13,289,256,545,edad 10
06707,Saladillo,14,246,245,491,edad 10
06707,Saladillo,15,255,226,481,edad 10
06707,Saladillo,16,253,253,506,edad 10
06707,Saladillo,17,221,242,463,edad 10
06707,Saladillo,18,240,214,454,edad 10
06707,Saladillo,19,229,197,426,edad 10
06707,Saladillo,20,216,221,437,edad 20
06707,Saladillo,21,218,231,449,edad 20
06707,Saladillo,22,219,203,422,edad 20
06707,Saladillo,23,215,188,403,edad 20
06707,Saladillo,24,201,206,407,edad 20
06707,Saladillo,25,193,206,399,edad 20
06707,Saladillo,26,167,192,359,edad 20
06707,Saladillo,27,178,173,351,edad 20
06707,Saladillo,28,170,206,376,edad 20
06707,Saladillo,29,184,195,379,edad 20
06707,Saladillo,30,203,220,423,edad 30
06707,Saladillo,31,157,174,331,edad 30
06707,Saladillo,32,165,164,329,edad 30
06707,Saladillo,33,149,161,310,edad 30
06707,Saladillo,34,157,164,321,edad 30
06707,Saladillo,35,168,196,364,edad 30
06707,Saladillo,36,156,186,342,edad 30
06707,Saladillo,37,157,187,344,edad 30
06707,Saladillo,38,191,192,383,edad 30
06707,Saladillo,39,172,163,335,edad 30
06707,Saladillo,40,187,175,362,edad 40
06707,Saladillo,41,198,181,379,edad 40
06707,Saladillo,42,175,167,342,edad 40
06707,Saladillo,43,178,171,349,edad 40
06707,Saladillo,44,161,177,338,edad 40
06707,Saladillo,45,152,183,335,edad 40
06707,Saladillo,46,147,163,310,edad 40
06707,Saladillo,47,155,165,320,edad 40
06707,Saladillo,48,174,171,345,edad 40
06707,Saladillo,49,158,158,316,edad 40
06707,Saladillo,50,178,206,384,edad 50
06707,Saladillo,51,184,158,342,edad 50
06707,Saladillo,52,150,169,319,edad 50
06707,Saladillo,53,168,181,349,edad 50
06707,Saladillo,54,186,185,371,edad 50
06707,Saladillo,55,149,168,317,edad 50
06707,Saladillo,56,170,176,346,edad 50
06707,Saladillo,57,158,155,313,edad 50
06707,Saladillo,58,160,140,300,edad 50
06707,Saladillo,59,158,136,294,edad 50
06707,Saladillo,60,150,172,322,edad 60
06707,Saladillo,61,150,149,299,edad 60
06707,Saladillo,62,120,140,260,edad 60
06707,Saladillo,63,138,143,281,edad 60
06707,Saladillo,64,139,151,290,edad 60
06707,Saladillo,65,143,142,285,edad 60
06707,Saladillo,66,117,134,251,edad 60
06707,Saladillo,67,103,145,248,edad 60
06707,Saladillo,68,111,128,239,edad 60
06707,Saladillo,69,96,120,216,edad 60
06707,Saladillo,70,117,145,262,edad 70
06707,Saladillo,71,100,141,241,edad 70
06707,Saladillo,72,109,116,225,edad 70
06707,Saladillo,73,96,117,213,edad 70
06707,Saladillo,74,93,120,213,edad 70
06707,Saladillo,75,77,108,185,edad 70
06707,Saladillo,76,80,113,193,edad 70
06707,Saladillo,77,85,102,187,edad 70
06707,Saladillo,78,66,111,177,edad 70
06707,Saladillo,79,65,90,155,edad 70
06707,Saladillo,80,50,101,151,edad 80
06707,Saladillo,81,52,75,127,edad 80
06707,Saladillo,82,51,79,130,edad 80
06707,Saladillo,83,41,70,111,edad 80
06707,Saladillo,84,41,56,97,edad 80
06707,Saladillo,85,21,42,63,edad 80
06707,Saladillo,86,16,58,74,edad 80
06707,Saladillo,87,17,48,65,edad 80
06707,Saladillo,88,34,32,66,edad 80
06707,Saladillo,89,12,33,45,edad 80
06707,Saladillo,90,12,19,31,edad 90
06707,Saladillo,91,8,21,29,edad 90
06707,Saladillo,92,9,13,22,edad 90
06707,Saladillo,93,3,11,14,edad 90
06707,Saladillo,94,3,5,8,edad 90
06707,Saladillo,95,3,6,9,edad 90
06707,Saladillo,96,0,3,3,edad 90
06707,Saladillo,97,2,6,8,edad 90
06707,Saladillo,98,0,1,1,edad 90
06714,Salto,0,231,229,460,edad 0
06714,Salto,1,225,245,470,edad 0
06714,Salto,2,245,248,493,edad 0
06714,Salto,3,252,245,497,edad 0
06714,Salto,4,228,231,459,edad 0
06714,Salto,5,251,243,494,edad 0
06714,Salto,6,267,236,503,edad 0
06714,Salto,7,236,241,477,edad 0
06714,Salto,8,220,229,449,edad 0
06714,Salto,9,248,280,528,edad 0
06714,Salto,10,262,272,534,edad 10
06714,Salto,11,274,240,514,edad 10
06714,Salto,12,240,258,498,edad 10
06714,Salto,13,266,251,517,edad 10
06714,Salto,14,267,215,482,edad 10
06714,Salto,15,247,227,474,edad 10
06714,Salto,16,260,241,501,edad 10
06714,Salto,17,262,244,506,edad 10
06714,Salto,18,240,209,449,edad 10
06714,Salto,19,202,205,407,edad 10
06714,Salto,20,211,184,395,edad 20
06714,Salto,21,204,201,405,edad 20
06714,Salto,22,196,192,388,edad 20
06714,Salto,23,177,205,382,edad 20
06714,Salto,24,185,212,397,edad 20
06714,Salto,25,174,186,360,edad 20
06714,Salto,26,201,210,411,edad 20
06714,Salto,27,172,184,356,edad 20
06714,Salto,28,214,213,427,edad 20
06714,Salto,29,189,187,376,edad 20
06714,Salto,30,191,220,411,edad 30
06714,Salto,31,175,183,358,edad 30
06714,Salto,32,169,185,354,edad 30
06714,Salto,33,167,164,331,edad 30
06714,Salto,34,149,187,336,edad 30
06714,Salto,35,214,172,386,edad 30
06714,Salto,36,180,202,382,edad 30
06714,Salto,37,169,176,345,edad 30
06714,Salto,38,166,189,355,edad 30
06714,Salto,39,195,168,363,edad 30
06714,Salto,40,184,160,344,edad 40
06714,Salto,41,200,167,367,edad 40
06714,Salto,42,181,198,379,edad 40
06714,Salto,43,159,165,324,edad 40
06714,Salto,44,170,181,351,edad 40
06714,Salto,45,178,182,360,edad 40
06714,Salto,46,180,189,369,edad 40
06714,Salto,47,185,162,347,edad 40
06714,Salto,48,168,167,335,edad 40
06714,Salto,49,176,188,364,edad 40
06714,Salto,50,163,176,339,edad 50
06714,Salto,51,192,156,348,edad 50
06714,Salto,52,158,151,309,edad 50
06714,Salto,53,147,173,320,edad 50
06714,Salto,54,136,137,273,edad 50
06714,Salto,55,125,163,288,edad 50
06714,Salto,56,157,157,314,edad 50
06714,Salto,57,146,130,276,edad 50
06714,Salto,58,134,111,245,edad 50
06714,Salto,59,108,119,227,edad 50
06714,Salto,60,133,122,255,edad 60
06714,Salto,61,115,139,254,edad 60
06714,Salto,62,122,130,252,edad 60
06714,Salto,63,132,141,273,edad 60
06714,Salto,64,118,138,256,edad 60
06714,Salto,65,120,135,255,edad 60
06714,Salto,66,114,124,238,edad 60
06714,Salto,67,139,147,286,edad 60
06714,Salto,68,103,115,218,edad 60
06714,Salto,69,104,128,232,edad 60
06714,Salto,70,97,140,237,edad 70
06714,Salto,71,121,133,254,edad 70
06714,Salto,72,101,141,242,edad 70
06714,Salto,73,90,124,214,edad 70
06714,Salto,74,70,98,168,edad 70
06714,Salto,75,106,133,239,edad 70
06714,Salto,76,78,104,182,edad 70
06714,Salto,77,78,102,180,edad 70
06714,Salto,78,75,103,178,edad 70
06714,Salto,79,71,71,142,edad 70
06714,Salto,80,48,77,125,edad 80
06714,Salto,81,47,91,138,edad 80
06714,Salto,82,44,66,110,edad 80
06714,Salto,83,38,55,93,edad 80
06714,Salto,84,27,49,76,edad 80
06714,Salto,85,28,45,73,edad 80
06714,Salto,86,19,54,73,edad 80
06714,Salto,87,20,43,63,edad 80
06714,Salto,88,8,28,36,edad 80
06714,Salto,89,17,20,37,edad 80
06714,Salto,90,2,18,20,edad 90
06714,Salto,91,5,12,17,edad 90
06714,Salto,92,5,22,27,edad 90
06714,Salto,93,1,10,11,edad 90
06714,Salto,94,2,3,5,edad 90
06714,Salto,95,0,5,5,edad 90
06714,Salto,96,1,2,3,edad 90
06714,Salto,97,0,4,4,edad 90
06714,Salto,98,1,4,5,edad 90
06714,Salto,99,0,4,4,edad 90
06721,Salliqueló,0,69,65,134,edad 0
06721,Salliqueló,1,58,57,115,edad 0
06721,Salliqueló,2,69,78,147,edad 0
06721,Salliqueló,3,59,69,128,edad 0
06721,Salliqueló,4,59,61,120,edad 0
06721,Salliqueló,5,82,69,151,edad 0
06721,Salliqueló,6,66,70,136,edad 0
06721,Salliqueló,7,77,62,139,edad 0
06721,Salliqueló,8,63,69,132,edad 0
06721,Salliqueló,9,74,74,148,edad 0
06721,Salliqueló,10,82,91,173,edad 10
06721,Salliqueló,11,103,70,173,edad 10
06721,Salliqueló,12,67,82,149,edad 10
06721,Salliqueló,13,74,84,158,edad 10
06721,Salliqueló,14,77,80,157,edad 10
06721,Salliqueló,15,86,74,160,edad 10
06721,Salliqueló,16,86,67,153,edad 10
06721,Salliqueló,17,84,77,161,edad 10
06721,Salliqueló,18,81,78,159,edad 10
06721,Salliqueló,19,69,52,121,edad 10
06721,Salliqueló,20,65,57,122,edad 20
06721,Salliqueló,21,53,64,117,edad 20
06721,Salliqueló,22,75,58,133,edad 20
06721,Salliqueló,23,59,57,116,edad 20
06721,Salliqueló,24,53,55,108,edad 20
06721,Salliqueló,25,61,64,125,edad 20
06721,Salliqueló,26,52,46,98,edad 20
06721,Salliqueló,27,60,63,123,edad 20
06721,Salliqueló,28,50,63,113,edad 20
06721,Salliqueló,29,56,52,108,edad 20
06721,Salliqueló,30,54,47,101,edad 30
06721,Salliqueló,31,51,52,103,edad 30
06721,Salliqueló,32,47,43,90,edad 30
06721,Salliqueló,33,41,54,95,edad 30
06721,Salliqueló,34,57,51,108,edad 30
06721,Salliqueló,35,48,43,91,edad 30
06721,Salliqueló,36,52,49,101,edad 30
06721,Salliqueló,37,60,71,131,edad 30
06721,Salliqueló,38,43,58,101,edad 30
06721,Salliqueló,39,61,49,110,edad 30
06721,Salliqueló,40,52,72,124,edad 40
06721,Salliqueló,41,50,60,110,edad 40
06721,Salliqueló,42,55,51,106,edad 40
06721,Salliqueló,43,53,53,106,edad 40
06721,Salliqueló,44,62,50,112,edad 40
06721,Salliqueló,45,40,62,102,edad 40
06721,Salliqueló,46,44,53,97,edad 40
06721,Salliqueló,47,59,37,96,edad 40
06721,Salliqueló,48,39,43,82,edad 40
06721,Salliqueló,49,46,55,101,edad 40
06721,Salliqueló,50,53,49,102,edad 50
06721,Salliqueló,51,59,54,113,edad 50
06721,Salliqueló,52,59,59,118,edad 50
06721,Salliqueló,53,44,60,104,edad 50
06721,Salliqueló,54,49,45,94,edad 50
06721,Salliqueló,55,37,36,73,edad 50
06721,Salliqueló,56,57,43,100,edad 50
06721,Salliqueló,57,53,36,89,edad 50
06721,Salliqueló,58,44,53,97,edad 50
06721,Salliqueló,59,33,33,66,edad 50
06721,Salliqueló,60,46,42,88,edad 60
06721,Salliqueló,61,34,44,78,edad 60
06721,Salliqueló,62,51,45,96,edad 60
06721,Salliqueló,63,33,48,81,edad 60
06721,Salliqueló,64,33,23,56,edad 60
06721,Salliqueló,65,32,42,74,edad 60
06721,Salliqueló,66,33,36,69,edad 60
06721,Salliqueló,67,38,41,79,edad 60
06721,Salliqueló,68,28,33,61,edad 60
06721,Salliqueló,69,24,31,55,edad 60
06721,Salliqueló,70,30,43,73,edad 70
06721,Salliqueló,71,31,30,61,edad 70
06721,Salliqueló,72,29,32,61,edad 70
06721,Salliqueló,73,33,28,61,edad 70
06721,Salliqueló,74,23,31,54,edad 70
06721,Salliqueló,75,15,25,40,edad 70
06721,Salliqueló,76,20,34,54,edad 70
06721,Salliqueló,77,24,34,58,edad 70
06721,Salliqueló,78,22,25,47,edad 70
06721,Salliqueló,79,19,23,42,edad 70
06721,Salliqueló,80,21,26,47,edad 80
06721,Salliqueló,81,9,18,27,edad 80
06721,Salliqueló,82,15,25,40,edad 80
06721,Salliqueló,83,5,16,21,edad 80
06721,Salliqueló,84,15,19,34,edad 80
06721,Salliqueló,85,8,10,18,edad 80
06721,Salliqueló,86,6,14,20,edad 80
06721,Salliqueló,87,9,13,22,edad 80
06721,Salliqueló,88,4,9,13,edad 80
06721,Salliqueló,89,3,9,12,edad 80
06721,Salliqueló,90,2,8,10,edad 90
06721,Salliqueló,91,4,3,7,edad 90
06721,Salliqueló,92,2,7,9,edad 90
06721,Salliqueló,93,1,2,3,edad 90
06721,Salliqueló,94,0,3,3,edad 90
06721,Salliqueló,95,2,1,3,edad 90
06721,Salliqueló,96,0,1,1,edad 90
06721,Salliqueló,98,2,0,2,edad 90
06721,Salliqueló,99,0,1,1,edad 90
06728,San Andrés de Giles,0,190,169,359,edad 0
06728,San Andrés de Giles,1,182,174,356,edad 0
06728,San Andrés de Giles,2,201,182,383,edad 0
06728,San Andrés de Giles,3,222,185,407,edad 0
06728,San Andrés de Giles,4,169,188,357,edad 0
06728,San Andrés de Giles,5,195,207,402,edad 0
06728,San Andrés de Giles,6,180,187,367,edad 0
06728,San Andrés de Giles,7,230,175,405,edad 0
06728,San Andrés de Giles,8,219,170,389,edad 0
06728,San Andrés de Giles,9,201,188,389,edad 0
06728,San Andrés de Giles,10,218,207,425,edad 10
06728,San Andrés de Giles,11,199,207,406,edad 10
06728,San Andrés de Giles,12,229,177,406,edad 10
06728,San Andrés de Giles,13,175,181,356,edad 10
06728,San Andrés de Giles,14,178,188,366,edad 10
06728,San Andrés de Giles,15,196,187,383,edad 10
06728,San Andrés de Giles,16,209,178,387,edad 10
06728,San Andrés de Giles,17,182,178,360,edad 10
06728,San Andrés de Giles,18,176,158,334,edad 10
06728,San Andrés de Giles,19,184,174,358,edad 10
06728,San Andrés de Giles,20,166,163,329,edad 20
06728,San Andrés de Giles,21,182,169,351,edad 20
06728,San Andrés de Giles,22,147,148,295,edad 20
06728,San Andrés de Giles,23,158,168,326,edad 20
06728,San Andrés de Giles,24,138,144,282,edad 20
06728,San Andrés de Giles,25,170,150,320,edad 20
06728,San Andrés de Giles,26,136,149,285,edad 20
06728,San Andrés de Giles,27,155,119,274,edad 20
06728,San Andrés de Giles,28,148,124,272,edad 20
06728,San Andrés de Giles,29,133,122,255,edad 20
06728,San Andrés de Giles,30,155,132,287,edad 30
06728,San Andrés de Giles,31,126,126,252,edad 30
06728,San Andrés de Giles,32,139,122,261,edad 30
06728,San Andrés de Giles,33,121,130,251,edad 30
06728,San Andrés de Giles,34,124,129,253,edad 30
06728,San Andrés de Giles,35,143,114,257,edad 30
06728,San Andrés de Giles,36,129,149,278,edad 30
06728,San Andrés de Giles,37,138,123,261,edad 30
06728,San Andrés de Giles,38,124,153,277,edad 30
06728,San Andrés de Giles,39,120,130,250,edad 30
06728,San Andrés de Giles,40,150,133,283,edad 40
06728,San Andrés de Giles,41,129,110,239,edad 40
06728,San Andrés de Giles,42,135,121,256,edad 40
06728,San Andrés de Giles,43,103,101,204,edad 40
06728,San Andrés de Giles,44,114,111,225,edad 40
06728,San Andrés de Giles,45,113,107,220,edad 40
06728,San Andrés de Giles,46,93,95,188,edad 40
06728,San Andrés de Giles,47,130,117,247,edad 40
06728,San Andrés de Giles,48,144,91,235,edad 40
06728,San Andrés de Giles,49,95,112,207,edad 40
06728,San Andrés de Giles,50,99,103,202,edad 50
06728,San Andrés de Giles,51,98,112,210,edad 50
06728,San Andrés de Giles,52,110,109,219,edad 50
06728,San Andrés de Giles,53,108,108,216,edad 50
06728,San Andrés de Giles,54,111,82,193,edad 50
06728,San Andrés de Giles,55,86,86,172,edad 50
06728,San Andrés de Giles,56,87,94,181,edad 50
06728,San Andrés de Giles,57,101,83,184,edad 50
06728,San Andrés de Giles,58,82,92,174,edad 50
06728,San Andrés de Giles,59,68,75,143,edad 50
06728,San Andrés de Giles,60,84,96,180,edad 60
06728,San Andrés de Giles,61,79,83,162,edad 60
06728,San Andrés de Giles,62,71,81,152,edad 60
06728,San Andrés de Giles,63,72,79,151,edad 60
06728,San Andrés de Giles,64,72,89,161,edad 60
06728,San Andrés de Giles,65,85,83,168,edad 60
06728,San Andrés de Giles,66,75,73,148,edad 60
06728,San Andrés de Giles,67,75,69,144,edad 60
06728,San Andrés de Giles,68,55,68,123,edad 60
06728,San Andrés de Giles,69,60,81,141,edad 60
06728,San Andrés de Giles,70,75,92,167,edad 70
06728,San Andrés de Giles,71,56,88,144,edad 70
06728,San Andrés de Giles,72,68,87,155,edad 70
06728,San Andrés de Giles,73,58,91,149,edad 70
06728,San Andrés de Giles,74,78,63,141,edad 70
06728,San Andrés de Giles,75,56,51,107,edad 70
06728,San Andrés de Giles,76,59,76,135,edad 70
06728,San Andrés de Giles,77,40,58,98,edad 70
06728,San Andrés de Giles,78,49,62,111,edad 70
06728,San Andrés de Giles,79,30,50,80,edad 70
06728,San Andrés de Giles,80,35,46,81,edad 80
06728,San Andrés de Giles,81,21,41,62,edad 80
06728,San Andrés de Giles,82,24,49,73,edad 80
06728,San Andrés de Giles,83,16,43,59,edad 80
06728,San Andrés de Giles,84,13,29,42,edad 80
06728,San Andrés de Giles,85,15,31,46,edad 80
06728,San Andrés de Giles,86,7,33,40,edad 80
06728,San Andrés de Giles,87,19,19,38,edad 80
06728,San Andrés de Giles,88,10,33,43,edad 80
06728,San Andrés de Giles,89,10,15,25,edad 80
06728,San Andrés de Giles,90,8,18,26,edad 90
06728,San Andrés de Giles,91,0,14,14,edad 90
06728,San Andrés de Giles,92,4,10,14,edad 90
06728,San Andrés de Giles,93,0,10,10,edad 90
06728,San Andrés de Giles,94,3,6,9,edad 90
06728,San Andrés de Giles,95,1,3,4,edad 90
06728,San Andrés de Giles,96,1,4,5,edad 90
06728,San Andrés de Giles,97,1,5,6,edad 90
06728,San Andrés de Giles,98,1,2,3,edad 90
06728,San Andrés de Giles,99,1,1,2,edad 90
06735,San Antonio de Areco,0,163,163,326,edad 0
06735,San Antonio de Areco,1,169,153,322,edad 0
06735,San Antonio de Areco,2,188,154,342,edad 0
06735,San Antonio de Areco,3,190,190,380,edad 0
06735,San Antonio de Areco,4,185,162,347,edad 0
06735,San Antonio de Areco,5,202,146,348,edad 0
06735,San Antonio de Areco,6,193,191,384,edad 0
06735,San Antonio de Areco,7,192,180,372,edad 0
06735,San Antonio de Areco,8,185,185,370,edad 0
06735,San Antonio de Areco,9,200,199,399,edad 0
06735,San Antonio de Areco,10,182,196,378,edad 10
06735,San Antonio de Areco,11,190,190,380,edad 10
06735,San Antonio de Areco,12,185,196,381,edad 10
06735,San Antonio de Areco,13,202,180,382,edad 10
06735,San Antonio de Areco,14,185,192,377,edad 10
06735,San Antonio de Areco,15,184,211,395,edad 10
06735,San Antonio de Areco,16,194,186,380,edad 10
06735,San Antonio de Areco,17,191,189,380,edad 10
06735,San Antonio de Areco,18,185,170,355,edad 10
06735,San Antonio de Areco,19,190,184,374,edad 10
06735,San Antonio de Areco,20,176,158,334,edad 20
06735,San Antonio de Areco,21,171,158,329,edad 20
06735,San Antonio de Areco,22,178,173,351,edad 20
06735,San Antonio de Areco,23,171,160,331,edad 20
06735,San Antonio de Areco,24,162,140,302,edad 20
06735,San Antonio de Areco,25,146,135,281,edad 20
06735,San Antonio de Areco,26,139,137,276,edad 20
06735,San Antonio de Areco,27,128,138,266,edad 20
06735,San Antonio de Areco,28,155,136,291,edad 20
06735,San Antonio de Areco,29,152,164,316,edad 20
06735,San Antonio de Areco,30,140,132,272,edad 30
06735,San Antonio de Areco,31,131,133,264,edad 30
06735,San Antonio de Areco,32,136,137,273,edad 30
06735,San Antonio de Areco,33,121,128,249,edad 30
06735,San Antonio de Areco,34,116,132,248,edad 30
06735,San Antonio de Areco,35,136,139,275,edad 30
06735,San Antonio de Areco,36,141,157,298,edad 30
06735,San Antonio de Areco,37,135,123,258,edad 30
06735,San Antonio de Areco,38,123,135,258,edad 30
06735,San Antonio de Areco,39,125,140,265,edad 30
06735,San Antonio de Areco,40,143,157,300,edad 40
06735,San Antonio de Areco,41,126,137,263,edad 40
06735,San Antonio de Areco,42,138,142,280,edad 40
06735,San Antonio de Areco,43,134,123,257,edad 40
06735,San Antonio de Areco,44,140,139,279,edad 40
06735,San Antonio de Areco,45,149,130,279,edad 40
06735,San Antonio de Areco,46,120,109,229,edad 40
06735,San Antonio de Areco,47,123,131,254,edad 40
06735,San Antonio de Areco,48,114,115,229,edad 40
06735,San Antonio de Areco,49,139,120,259,edad 40
06735,San Antonio de Areco,50,98,126,224,edad 50
06735,San Antonio de Areco,51,126,114,240,edad 50
06735,San Antonio de Areco,52,127,121,248,edad 50
06735,San Antonio de Areco,53,114,132,246,edad 50
06735,San Antonio de Areco,54,98,98,196,edad 50
06735,San Antonio de Areco,55,81,104,185,edad 50
06735,San Antonio de Areco,56,126,103,229,edad 50
06735,San Antonio de Areco,57,97,93,190,edad 50
06735,San Antonio de Areco,58,91,101,192,edad 50
06735,San Antonio de Areco,59,80,75,155,edad 50
06735,San Antonio de Areco,60,92,92,184,edad 60
06735,San Antonio de Areco,61,91,85,176,edad 60
06735,San Antonio de Areco,62,76,90,166,edad 60
06735,San Antonio de Areco,63,78,88,166,edad 60
06735,San Antonio de Areco,64,72,71,143,edad 60
06735,San Antonio de Areco,65,82,98,180,edad 60
06735,San Antonio de Areco,66,66,84,150,edad 60
06735,San Antonio de Areco,67,88,75,163,edad 60
06735,San Antonio de Areco,68,75,81,156,edad 60
06735,San Antonio de Areco,69,69,78,147,edad 60
06735,San Antonio de Areco,70,69,99,168,edad 70
06735,San Antonio de Areco,71,60,80,140,edad 70
06735,San Antonio de Areco,72,62,82,144,edad 70
06735,San Antonio de Areco,73,52,67,119,edad 70
06735,San Antonio de Areco,74,40,83,123,edad 70
06735,San Antonio de Areco,75,47,87,134,edad 70
06735,San Antonio de Areco,76,54,74,128,edad 70
06735,San Antonio de Areco,77,35,50,85,edad 70
06735,San Antonio de Areco,78,45,61,106,edad 70
06735,San Antonio de Areco,79,31,47,78,edad 70
06735,San Antonio de Areco,80,33,68,101,edad 80
06735,San Antonio de Areco,81,29,48,77,edad 80
06735,San Antonio de Areco,82,19,52,71,edad 80
06735,San Antonio de Areco,83,16,31,47,edad 80
06735,San Antonio de Areco,84,19,34,53,edad 80
06735,San Antonio de Areco,85,6,40,46,edad 80
06735,San Antonio de Areco,86,9,32,41,edad 80
06735,San Antonio de Areco,87,10,27,37,edad 80
06735,San Antonio de Areco,88,10,27,37,edad 80
06735,San Antonio de Areco,89,7,23,30,edad 80
06735,San Antonio de Areco,90,3,14,17,edad 90
06735,San Antonio de Areco,91,4,16,20,edad 90
06735,San Antonio de Areco,92,7,13,20,edad 90
06735,San Antonio de Areco,93,3,8,11,edad 90
06735,San Antonio de Areco,94,2,7,9,edad 90
06735,San Antonio de Areco,95,0,4,4,edad 90
06735,San Antonio de Areco,96,1,4,5,edad 90
06735,San Antonio de Areco,97,0,3,3,edad 90
06735,San Antonio de Areco,98,0,2,2,edad 90
06735,San Antonio de Areco,99,0,2,2,edad 90
06742,San Cayetano,0,75,50,125,edad 0
06742,San Cayetano,1,48,63,111,edad 0
06742,San Cayetano,2,51,53,104,edad 0
06742,San Cayetano,3,43,65,108,edad 0
06742,San Cayetano,4,66,56,122,edad 0
06742,San Cayetano,5,66,60,126,edad 0
06742,San Cayetano,6,65,86,151,edad 0
06742,San Cayetano,7,67,54,121,edad 0
06742,San Cayetano,8,66,75,141,edad 0
06742,San Cayetano,9,88,55,143,edad 0
06742,San Cayetano,10,68,86,154,edad 10
06742,San Cayetano,11,70,73,143,edad 10
06742,San Cayetano,12,75,67,142,edad 10
06742,San Cayetano,13,77,52,129,edad 10
06742,San Cayetano,14,79,61,140,edad 10
06742,San Cayetano,15,65,67,132,edad 10
06742,San Cayetano,16,74,84,158,edad 10
06742,San Cayetano,17,62,69,131,edad 10
06742,San Cayetano,18,57,51,108,edad 10
06742,San Cayetano,19,50,53,103,edad 10
06742,San Cayetano,20,55,48,103,edad 20
06742,San Cayetano,21,46,46,92,edad 20
06742,San Cayetano,22,60,47,107,edad 20
06742,San Cayetano,23,40,47,87,edad 20
06742,San Cayetano,24,54,62,116,edad 20
06742,San Cayetano,25,56,58,114,edad 20
06742,San Cayetano,26,55,60,115,edad 20
06742,San Cayetano,27,48,60,108,edad 20
06742,San Cayetano,28,43,59,102,edad 20
06742,San Cayetano,29,56,52,108,edad 20
06742,San Cayetano,30,56,47,103,edad 30
06742,San Cayetano,31,38,52,90,edad 30
06742,San Cayetano,32,49,47,96,edad 30
06742,San Cayetano,33,53,44,97,edad 30
06742,San Cayetano,34,53,52,105,edad 30
06742,San Cayetano,35,59,53,112,edad 30
06742,San Cayetano,36,55,55,110,edad 30
06742,San Cayetano,37,56,55,111,edad 30
06742,San Cayetano,38,52,45,97,edad 30
06742,San Cayetano,39,40,51,91,edad 30
06742,San Cayetano,40,55,35,90,edad 40
06742,San Cayetano,41,53,54,107,edad 40
06742,San Cayetano,42,52,57,109,edad 40
06742,San Cayetano,43,48,57,105,edad 40
06742,San Cayetano,44,47,38,85,edad 40
06742,San Cayetano,45,55,45,100,edad 40
06742,San Cayetano,46,42,58,100,edad 40
06742,San Cayetano,47,56,51,107,edad 40
06742,San Cayetano,48,44,42,86,edad 40
06742,San Cayetano,49,40,49,89,edad 40
06742,San Cayetano,50,43,57,100,edad 50
06742,San Cayetano,51,63,44,107,edad 50
06742,San Cayetano,52,60,39,99,edad 50
06742,San Cayetano,53,45,61,106,edad 50
06742,San Cayetano,54,46,46,92,edad 50
06742,San Cayetano,55,51,35,86,edad 50
06742,San Cayetano,56,51,51,102,edad 50
06742,San Cayetano,57,43,38,81,edad 50
06742,San Cayetano,58,31,57,88,edad 50
06742,San Cayetano,59,48,34,82,edad 50
06742,San Cayetano,60,41,29,70,edad 60
06742,San Cayetano,61,34,42,76,edad 60
06742,San Cayetano,62,44,38,82,edad 60
06742,San Cayetano,63,53,45,98,edad 60
06742,San Cayetano,64,32,50,82,edad 60
06742,San Cayetano,65,38,34,72,edad 60
06742,San Cayetano,66,32,40,72,edad 60
06742,San Cayetano,67,31,25,56,edad 60
06742,San Cayetano,68,31,34,65,edad 60
06742,San Cayetano,69,39,28,67,edad 60
06742,San Cayetano,70,26,30,56,edad 70
06742,San Cayetano,71,28,36,64,edad 70
06742,San Cayetano,72,19,35,54,edad 70
06742,San Cayetano,73,36,44,80,edad 70
06742,San Cayetano,74,32,28,60,edad 70
06742,San Cayetano,75,22,26,48,edad 70
06742,San Cayetano,76,26,25,51,edad 70
06742,San Cayetano,77,19,24,43,edad 70
06742,San Cayetano,78,15,26,41,edad 70
06742,San Cayetano,79,19,18,37,edad 70
06742,San Cayetano,80,16,29,45,edad 80
06742,San Cayetano,81,15,25,40,edad 80
06742,San Cayetano,82,15,15,30,edad 80
06742,San Cayetano,83,10,12,22,edad 80
06742,San Cayetano,84,10,22,32,edad 80
06742,San Cayetano,85,8,10,18,edad 80
06742,San Cayetano,86,8,12,20,edad 80
06742,San Cayetano,87,3,11,14,edad 80
06742,San Cayetano,88,4,2,6,edad 80
06742,San Cayetano,89,2,11,13,edad 80
06742,San Cayetano,90,3,2,5,edad 90
06742,San Cayetano,91,1,6,7,edad 90
06742,San Cayetano,92,4,4,8,edad 90
06742,San Cayetano,93,2,1,3,edad 90
06742,San Cayetano,94,0,1,1,edad 90
06742,San Cayetano,95,0,1,1,edad 90
06742,San Cayetano,96,0,1,1,edad 90
06742,San Cayetano,98,0,1,1,edad 90
06742,San Cayetano,99,1,0,1,edad 90
06763,San Nicolás,0,1197,1119,2316,edad 0
06763,San Nicolás,1,1082,1006,2088,edad 0
06763,San Nicolás,2,1180,1143,2323,edad 0
06763,San Nicolás,3,1136,1143,2279,edad 0
06763,San Nicolás,4,1177,1180,2357,edad 0
06763,San Nicolás,5,1196,1176,2372,edad 0
06763,San Nicolás,6,1177,1137,2314,edad 0
06763,San Nicolás,7,1138,1201,2339,edad 0
06763,San Nicolás,8,1203,1149,2352,edad 0
06763,San Nicolás,9,1192,1235,2427,edad 0
06763,San Nicolás,10,1302,1304,2606,edad 10
06763,San Nicolás,11,1399,1274,2673,edad 10
06763,San Nicolás,12,1342,1183,2525,edad 10
06763,San Nicolás,13,1201,1207,2408,edad 10
06763,San Nicolás,14,1244,1234,2478,edad 10
06763,San Nicolás,15,1247,1249,2496,edad 10
06763,San Nicolás,16,1293,1194,2487,edad 10
06763,San Nicolás,17,1257,1169,2426,edad 10
06763,San Nicolás,18,1196,1172,2368,edad 10
06763,San Nicolás,19,1279,1223,2502,edad 10
06763,San Nicolás,20,1237,1273,2510,edad 20
06763,San Nicolás,21,1318,1352,2670,edad 20
06763,San Nicolás,22,1184,1191,2375,edad 20
06763,San Nicolás,23,1150,1178,2328,edad 20
06763,San Nicolás,24,1176,1130,2306,edad 20
06763,San Nicolás,25,1107,1163,2270,edad 20
06763,San Nicolás,26,995,1037,2032,edad 20
06763,San Nicolás,27,1046,1024,2070,edad 20
06763,San Nicolás,28,951,985,1936,edad 20
06763,San Nicolás,29,876,876,1752,edad 20
06763,San Nicolás,30,963,992,1955,edad 30
06763,San Nicolás,31,887,894,1781,edad 30
06763,San Nicolás,32,813,894,1707,edad 30
06763,San Nicolás,33,814,852,1666,edad 30
06763,San Nicolás,34,822,838,1660,edad 30
06763,San Nicolás,35,875,950,1825,edad 30
06763,San Nicolás,36,834,919,1753,edad 30
06763,San Nicolás,37,896,917,1813,edad 30
06763,San Nicolás,38,869,928,1797,edad 30
06763,San Nicolás,39,847,888,1735,edad 30
06763,San Nicolás,40,858,908,1766,edad 40
06763,San Nicolás,41,828,866,1694,edad 40
06763,San Nicolás,42,858,847,1705,edad 40
06763,San Nicolás,43,787,853,1640,edad 40
06763,San Nicolás,44,754,801,1555,edad 40
06763,San Nicolás,45,796,898,1694,edad 40
06763,San Nicolás,46,747,861,1608,edad 40
06763,San Nicolás,47,733,825,1558,edad 40
06763,San Nicolás,48,775,831,1606,edad 40
06763,San Nicolás,49,741,780,1521,edad 40
06763,San Nicolás,50,793,912,1705,edad 50
06763,San Nicolás,51,830,742,1572,edad 50
06763,San Nicolás,52,780,751,1531,edad 50
06763,San Nicolás,53,715,760,1475,edad 50
06763,San Nicolás,54,666,692,1358,edad 50
06763,San Nicolás,55,617,671,1288,edad 50
06763,San Nicolás,56,692,726,1418,edad 50
06763,San Nicolás,57,596,639,1235,edad 50
06763,San Nicolás,58,516,626,1142,edad 50
06763,San Nicolás,59,529,589,1118,edad 50
06763,San Nicolás,60,579,655,1234,edad 60
06763,San Nicolás,61,523,573,1096,edad 60
06763,San Nicolás,62,537,579,1116,edad 60
06763,San Nicolás,63,531,564,1095,edad 60
06763,San Nicolás,64,551,543,1094,edad 60
06763,San Nicolás,65,495,569,1064,edad 60
06763,San Nicolás,66,451,501,952,edad 60
06763,San Nicolás,67,457,463,920,edad 60
06763,San Nicolás,68,415,455,870,edad 60
06763,San Nicolás,69,409,480,889,edad 60
06763,San Nicolás,70,363,522,885,edad 70
06763,San Nicolás,71,382,442,824,edad 70
06763,San Nicolás,72,341,416,757,edad 70
06763,San Nicolás,73,312,441,753,edad 70
06763,San Nicolás,74,277,405,682,edad 70
06763,San Nicolás,75,260,386,646,edad 70
06763,San Nicolás,76,216,362,578,edad 70
06763,San Nicolás,77,215,323,538,edad 70
06763,San Nicolás,78,170,284,454,edad 70
06763,San Nicolás,79,159,270,429,edad 70
06763,San Nicolás,80,161,238,399,edad 80
06763,San Nicolás,81,117,217,334,edad 80
06763,San Nicolás,82,98,213,311,edad 80
06763,San Nicolás,83,92,202,294,edad 80
06763,San Nicolás,84,78,167,245,edad 80
06763,San Nicolás,85,70,162,232,edad 80
06763,San Nicolás,86,59,129,188,edad 80
06763,San Nicolás,87,43,113,156,edad 80
06763,San Nicolás,88,49,98,147,edad 80
06763,San Nicolás,89,38,78,116,edad 80
06763,San Nicolás,90,25,61,86,edad 90
06763,San Nicolás,91,13,44,57,edad 90
06763,San Nicolás,92,17,32,49,edad 90
06763,San Nicolás,93,9,25,34,edad 90
06763,San Nicolás,94,9,18,27,edad 90
06763,San Nicolás,95,3,6,9,edad 90
06763,San Nicolás,96,3,10,13,edad 90
06763,San Nicolás,97,1,13,14,edad 90
06763,San Nicolás,98,2,3,5,edad 90
06763,San Nicolás,99,1,2,3,edad 90
06763,San Nicolás,110,0,1,1,edad 110
06770,San Pedro,0,546,578,1124,edad 0
06770,San Pedro,1,476,522,998,edad 0
06770,San Pedro,2,558,551,1109,edad 0
06770,San Pedro,3,554,534,1088,edad 0
06770,San Pedro,4,559,547,1106,edad 0
06770,San Pedro,5,605,560,1165,edad 0
06770,San Pedro,6,556,529,1085,edad 0
06770,San Pedro,7,522,537,1059,edad 0
06770,San Pedro,8,543,533,1076,edad 0
06770,San Pedro,9,565,571,1136,edad 0
06770,San Pedro,10,625,563,1188,edad 10
06770,San Pedro,11,568,534,1102,edad 10
06770,San Pedro,12,566,480,1046,edad 10
06770,San Pedro,13,520,519,1039,edad 10
06770,San Pedro,14,460,489,949,edad 10
06770,San Pedro,15,541,552,1093,edad 10
06770,San Pedro,16,485,483,968,edad 10
06770,San Pedro,17,465,433,898,edad 10
06770,San Pedro,18,524,468,992,edad 10
06770,San Pedro,19,505,445,950,edad 10
06770,San Pedro,20,471,464,935,edad 20
06770,San Pedro,21,506,487,993,edad 20
06770,San Pedro,22,484,404,888,edad 20
06770,San Pedro,23,507,446,953,edad 20
06770,San Pedro,24,505,448,953,edad 20
06770,San Pedro,25,383,440,823,edad 20
06770,San Pedro,26,395,389,784,edad 20
06770,San Pedro,27,397,406,803,edad 20
06770,San Pedro,28,370,399,769,edad 20
06770,San Pedro,29,321,313,634,edad 20
06770,San Pedro,30,367,343,710,edad 30
06770,San Pedro,31,326,351,677,edad 30
06770,San Pedro,32,306,323,629,edad 30
06770,San Pedro,33,297,368,665,edad 30
06770,San Pedro,34,308,314,622,edad 30
06770,San Pedro,35,330,337,667,edad 30
06770,San Pedro,36,339,316,655,edad 30
06770,San Pedro,37,326,310,636,edad 30
06770,San Pedro,38,356,361,717,edad 30
06770,San Pedro,39,349,347,696,edad 30
06770,San Pedro,40,344,305,649,edad 40
06770,San Pedro,41,310,335,645,edad 40
06770,San Pedro,42,345,317,662,edad 40
06770,San Pedro,43,334,301,635,edad 40
06770,San Pedro,44,312,302,614,edad 40
06770,San Pedro,45,315,331,646,edad 40
06770,San Pedro,46,327,271,598,edad 40
06770,San Pedro,47,317,318,635,edad 40
06770,San Pedro,48,301,262,563,edad 40
06770,San Pedro,49,287,302,589,edad 40
06770,San Pedro,50,314,297,611,edad 50
06770,San Pedro,51,272,281,553,edad 50
06770,San Pedro,52,270,240,510,edad 50
06770,San Pedro,53,297,280,577,edad 50
06770,San Pedro,54,236,219,455,edad 50
06770,San Pedro,55,232,217,449,edad 50
06770,San Pedro,56,271,249,520,edad 50
06770,San Pedro,57,236,205,441,edad 50
06770,San Pedro,58,221,202,423,edad 50
06770,San Pedro,59,192,176,368,edad 50
06770,San Pedro,60,182,211,393,edad 60
06770,San Pedro,61,187,186,373,edad 60
06770,San Pedro,62,167,185,352,edad 60
06770,San Pedro,63,168,202,370,edad 60
06770,San Pedro,64,147,176,323,edad 60
06770,San Pedro,65,185,185,370,edad 60
06770,San Pedro,66,149,160,309,edad 60
06770,San Pedro,67,163,198,361,edad 60
06770,San Pedro,68,160,170,330,edad 60
06770,San Pedro,69,162,166,328,edad 60
06770,San Pedro,70,167,212,379,edad 70
06770,San Pedro,71,149,181,330,edad 70
06770,San Pedro,72,155,177,332,edad 70
06770,San Pedro,73,140,156,296,edad 70
06770,San Pedro,74,123,155,278,edad 70
06770,San Pedro,75,111,168,279,edad 70
06770,San Pedro,76,111,147,258,edad 70
06770,San Pedro,77,96,156,252,edad 70
06770,San Pedro,78,89,162,251,edad 70
06770,San Pedro,79,83,132,215,edad 70
06770,San Pedro,80,72,126,198,edad 80
06770,San Pedro,81,55,106,161,edad 80
06770,San Pedro,82,56,98,154,edad 80
06770,San Pedro,83,51,82,133,edad 80
06770,San Pedro,84,35,74,109,edad 80
06770,San Pedro,85,40,77,117,edad 80
06770,San Pedro,86,37,53,90,edad 80
06770,San Pedro,87,36,61,97,edad 80
06770,San Pedro,88,14,42,56,edad 80
06770,San Pedro,89,20,37,57,edad 80
06770,San Pedro,90,15,26,41,edad 90
06770,San Pedro,91,11,21,32,edad 90
06770,San Pedro,92,8,21,29,edad 90
06770,San Pedro,93,4,7,11,edad 90
06770,San Pedro,94,5,9,14,edad 90
06770,San Pedro,95,3,8,11,edad 90
06770,San Pedro,96,3,7,10,edad 90
06770,San Pedro,97,1,5,6,edad 90
06770,San Pedro,98,1,2,3,edad 90
06770,San Pedro,99,2,1,3,edad 90
06778,San Vicente,0,553,500,1053,edad 0
06778,San Vicente,1,423,463,886,edad 0
06778,San Vicente,2,491,488,979,edad 0
06778,San Vicente,3,525,483,1008,edad 0
06778,San Vicente,4,490,532,1022,edad 0
06778,San Vicente,5,519,520,1039,edad 0
06778,San Vicente,6,447,493,940,edad 0
06778,San Vicente,7,492,454,946,edad 0
06778,San Vicente,8,501,454,955,edad 0
06778,San Vicente,9,480,493,973,edad 0
06778,San Vicente,10,483,512,995,edad 10
06778,San Vicente,11,482,476,958,edad 10
06778,San Vicente,12,437,447,884,edad 10
06778,San Vicente,13,479,393,872,edad 10
06778,San Vicente,14,438,409,847,edad 10
06778,San Vicente,15,392,379,771,edad 10
06778,San Vicente,16,438,421,859,edad 10
06778,San Vicente,17,398,362,760,edad 10
06778,San Vicente,18,405,339,744,edad 10
06778,San Vicente,19,405,428,833,edad 10
06778,San Vicente,20,413,380,793,edad 20
06778,San Vicente,21,399,383,782,edad 20
06778,San Vicente,22,362,359,721,edad 20
06778,San Vicente,23,374,398,772,edad 20
06778,San Vicente,24,351,376,727,edad 20
06778,San Vicente,25,334,370,704,edad 20
06778,San Vicente,26,351,324,675,edad 20
06778,San Vicente,27,312,332,644,edad 20
06778,San Vicente,28,321,352,673,edad 20
06778,San Vicente,29,336,318,654,edad 20
06778,San Vicente,30,333,338,671,edad 30
06778,San Vicente,31,298,287,585,edad 30
06778,San Vicente,32,281,331,612,edad 30
06778,San Vicente,33,269,271,540,edad 30
06778,San Vicente,34,241,273,514,edad 30
06778,San Vicente,35,252,267,519,edad 30
06778,San Vicente,36,265,266,531,edad 30
06778,San Vicente,37,237,243,480,edad 30
06778,San Vicente,38,298,311,609,edad 30
06778,San Vicente,39,233,271,504,edad 30
06778,San Vicente,40,256,276,532,edad 40
06778,San Vicente,41,269,249,518,edad 40
06778,San Vicente,42,215,242,457,edad 40
06778,San Vicente,43,244,258,502,edad 40
06778,San Vicente,44,210,213,423,edad 40
06778,San Vicente,45,231,238,469,edad 40
06778,San Vicente,46,244,246,490,edad 40
06778,San Vicente,47,240,242,482,edad 40
06778,San Vicente,48,258,235,493,edad 40
06778,San Vicente,49,215,210,425,edad 40
06778,San Vicente,50,245,247,492,edad 50
06778,San Vicente,51,206,196,402,edad 50
06778,San Vicente,52,213,217,430,edad 50
06778,San Vicente,53,188,193,381,edad 50
06778,San Vicente,54,202,173,375,edad 50
06778,San Vicente,55,150,184,334,edad 50
06778,San Vicente,56,194,193,387,edad 50
06778,San Vicente,57,147,144,291,edad 50
06778,San Vicente,58,171,132,303,edad 50
06778,San Vicente,59,137,154,291,edad 50
06778,San Vicente,60,158,131,289,edad 60
06778,San Vicente,61,124,147,271,edad 60
06778,San Vicente,62,123,138,261,edad 60
06778,San Vicente,63,125,155,280,edad 60
06778,San Vicente,64,103,119,222,edad 60
06778,San Vicente,65,132,131,263,edad 60
06778,San Vicente,66,113,112,225,edad 60
06778,San Vicente,67,112,120,232,edad 60
06778,San Vicente,68,88,116,204,edad 60
06778,San Vicente,69,114,135,249,edad 60
06778,San Vicente,70,97,119,216,edad 70
06778,San Vicente,71,92,92,184,edad 70
06778,San Vicente,72,105,113,218,edad 70
06778,San Vicente,73,87,104,191,edad 70
06778,San Vicente,74,69,133,202,edad 70
06778,San Vicente,75,60,85,145,edad 70
06778,San Vicente,76,52,101,153,edad 70
06778,San Vicente,77,58,84,142,edad 70
06778,San Vicente,78,49,78,127,edad 70
06778,San Vicente,79,50,86,136,edad 70
06778,San Vicente,80,44,78,122,edad 80
06778,San Vicente,81,39,64,103,edad 80
06778,San Vicente,82,46,45,91,edad 80
06778,San Vicente,83,18,55,73,edad 80
06778,San Vicente,84,25,51,76,edad 80
06778,San Vicente,85,21,42,63,edad 80
06778,San Vicente,86,16,36,52,edad 80
06778,San Vicente,87,15,32,47,edad 80
06778,San Vicente,88,8,24,32,edad 80
06778,San Vicente,89,8,26,34,edad 80
06778,San Vicente,90,12,16,28,edad 90
06778,San Vicente,91,6,14,20,edad 90
06778,San Vicente,92,9,12,21,edad 90
06778,San Vicente,93,4,12,16,edad 90
06778,San Vicente,94,1,5,6,edad 90
06778,San Vicente,95,0,8,8,edad 90
06778,San Vicente,96,3,3,6,edad 90
06778,San Vicente,97,1,3,4,edad 90
06778,San Vicente,98,0,1,1,edad 90
06784,Suipacha,0,83,58,141,edad 0
06784,Suipacha,1,74,73,147,edad 0
06784,Suipacha,2,84,79,163,edad 0
06784,Suipacha,3,77,68,145,edad 0
06784,Suipacha,4,84,76,160,edad 0
06784,Suipacha,5,73,74,147,edad 0
06784,Suipacha,6,71,83,154,edad 0
06784,Suipacha,7,85,72,157,edad 0
06784,Suipacha,8,92,80,172,edad 0
06784,Suipacha,9,81,67,148,edad 0
06784,Suipacha,10,92,111,203,edad 10
06784,Suipacha,11,89,87,176,edad 10
06784,Suipacha,12,87,65,152,edad 10
06784,Suipacha,13,116,64,180,edad 10
06784,Suipacha,14,77,91,168,edad 10
06784,Suipacha,15,94,74,168,edad 10
06784,Suipacha,16,92,91,183,edad 10
06784,Suipacha,17,63,70,133,edad 10
06784,Suipacha,18,85,61,146,edad 10
06784,Suipacha,19,81,77,158,edad 10
06784,Suipacha,20,77,63,140,edad 20
06784,Suipacha,21,74,89,163,edad 20
06784,Suipacha,22,76,76,152,edad 20
06784,Suipacha,23,72,65,137,edad 20
06784,Suipacha,24,68,57,125,edad 20
06784,Suipacha,25,61,58,119,edad 20
06784,Suipacha,26,62,52,114,edad 20
06784,Suipacha,27,53,60,113,edad 20
06784,Suipacha,28,63,59,122,edad 20
06784,Suipacha,29,38,64,102,edad 20
06784,Suipacha,30,73,51,124,edad 30
06784,Suipacha,31,55,47,102,edad 30
06784,Suipacha,32,44,45,89,edad 30
06784,Suipacha,33,52,46,98,edad 30
06784,Suipacha,34,54,63,117,edad 30
06784,Suipacha,35,56,54,110,edad 30
06784,Suipacha,36,48,57,105,edad 30
06784,Suipacha,37,52,66,118,edad 30
06784,Suipacha,38,44,52,96,edad 30
06784,Suipacha,39,60,51,111,edad 30
06784,Suipacha,40,55,59,114,edad 40
06784,Suipacha,41,67,42,109,edad 40
06784,Suipacha,42,58,63,121,edad 40
06784,Suipacha,43,68,56,124,edad 40
06784,Suipacha,44,45,52,97,edad 40
06784,Suipacha,45,51,51,102,edad 40
06784,Suipacha,46,52,36,88,edad 40
06784,Suipacha,47,51,44,95,edad 40
06784,Suipacha,48,58,54,112,edad 40
06784,Suipacha,49,49,53,102,edad 40
06784,Suipacha,50,44,52,96,edad 50
06784,Suipacha,51,54,46,100,edad 50
06784,Suipacha,52,58,53,111,edad 50
06784,Suipacha,53,47,44,91,edad 50
06784,Suipacha,54,37,50,87,edad 50
06784,Suipacha,55,38,39,77,edad 50
06784,Suipacha,56,37,41,78,edad 50
06784,Suipacha,57,35,46,81,edad 50
06784,Suipacha,58,36,40,76,edad 50
06784,Suipacha,59,41,38,79,edad 50
06784,Suipacha,60,48,40,88,edad 60
06784,Suipacha,61,30,41,71,edad 60
06784,Suipacha,62,34,33,67,edad 60
06784,Suipacha,63,30,40,70,edad 60
06784,Suipacha,64,35,34,69,edad 60
06784,Suipacha,65,34,45,79,edad 60
06784,Suipacha,66,35,36,71,edad 60
06784,Suipacha,67,35,27,62,edad 60
06784,Suipacha,68,34,27,61,edad 60
06784,Suipacha,69,28,39,67,edad 60
06784,Suipacha,70,28,35,63,edad 70
06784,Suipacha,71,28,42,70,edad 70
06784,Suipacha,72,24,19,43,edad 70
06784,Suipacha,73,27,23,50,edad 70
06784,Suipacha,74,30,32,62,edad 70
06784,Suipacha,75,19,31,50,edad 70
06784,Suipacha,76,18,27,45,edad 70
06784,Suipacha,77,23,20,43,edad 70
06784,Suipacha,78,15,22,37,edad 70
06784,Suipacha,79,14,13,27,edad 70
06784,Suipacha,80,11,18,29,edad 80
06784,Suipacha,81,6,21,27,edad 80
06784,Suipacha,82,10,18,28,edad 80
06784,Suipacha,83,13,13,26,edad 80
06784,Suipacha,84,7,5,12,edad 80
06784,Suipacha,85,3,11,14,edad 80
06784,Suipacha,86,3,7,10,edad 80
06784,Suipacha,87,3,9,12,edad 80
06784,Suipacha,88,6,6,12,edad 80
06784,Suipacha,89,2,4,6,edad 80
06784,Suipacha,90,1,11,12,edad 90
06784,Suipacha,91,1,5,6,edad 90
06784,Suipacha,92,1,7,8,edad 90
06784,Suipacha,93,0,1,1,edad 90
06784,Suipacha,94,0,2,2,edad 90
06784,Suipacha,95,0,1,1,edad 90
06784,Suipacha,96,0,2,2,edad 90
06784,Suipacha,97,0,2,2,edad 90
06784,Suipacha,98,0,1,1,edad 90
06791,Tandil,0,905,834,1739,edad 0
06791,Tandil,1,777,746,1523,edad 0
06791,Tandil,2,850,823,1673,edad 0
06791,Tandil,3,801,795,1596,edad 0
06791,Tandil,4,869,773,1642,edad 0
06791,Tandil,5,865,795,1660,edad 0
06791,Tandil,6,856,776,1632,edad 0
06791,Tandil,7,841,820,1661,edad 0
06791,Tandil,8,883,869,1752,edad 0
06791,Tandil,9,903,912,1815,edad 0
06791,Tandil,10,1035,962,1997,edad 10
06791,Tandil,11,970,992,1962,edad 10
06791,Tandil,12,934,885,1819,edad 10
06791,Tandil,13,887,863,1750,edad 10
06791,Tandil,14,903,872,1775,edad 10
06791,Tandil,15,899,907,1806,edad 10
06791,Tandil,16,907,865,1772,edad 10
06791,Tandil,17,902,901,1803,edad 10
06791,Tandil,18,917,877,1794,edad 10
06791,Tandil,19,936,854,1790,edad 10
06791,Tandil,20,961,924,1885,edad 20
06791,Tandil,21,978,951,1929,edad 20
06791,Tandil,22,973,937,1910,edad 20
06791,Tandil,23,920,875,1795,edad 20
06791,Tandil,24,879,858,1737,edad 20
06791,Tandil,25,813,879,1692,edad 20
06791,Tandil,26,802,805,1607,edad 20
06791,Tandil,27,784,758,1542,edad 20
06791,Tandil,28,752,701,1453,edad 20
06791,Tandil,29,662,734,1396,edad 20
06791,Tandil,30,764,758,1522,edad 30
06791,Tandil,31,702,732,1434,edad 30
06791,Tandil,32,641,708,1349,edad 30
06791,Tandil,33,639,701,1340,edad 30
06791,Tandil,34,625,632,1257,edad 30
06791,Tandil,35,623,668,1291,edad 30
06791,Tandil,36,648,703,1351,edad 30
06791,Tandil,37,710,714,1424,edad 30
06791,Tandil,38,652,672,1324,edad 30
06791,Tandil,39,645,667,1312,edad 30
06791,Tandil,40,644,734,1378,edad 40
06791,Tandil,41,667,659,1326,edad 40
06791,Tandil,42,655,676,1331,edad 40
06791,Tandil,43,620,652,1272,edad 40
06791,Tandil,44,607,637,1244,edad 40
06791,Tandil,45,632,672,1304,edad 40
06791,Tandil,46,593,636,1229,edad 40
06791,Tandil,47,565,660,1225,edad 40
06791,Tandil,48,614,596,1210,edad 40
06791,Tandil,49,560,587,1147,edad 40
06791,Tandil,50,602,678,1280,edad 50
06791,Tandil,51,603,714,1317,edad 50
06791,Tandil,52,609,616,1225,edad 50
06791,Tandil,53,558,600,1158,edad 50
06791,Tandil,54,510,579,1089,edad 50
06791,Tandil,55,554,634,1188,edad 50
06791,Tandil,56,523,607,1130,edad 50
06791,Tandil,57,511,552,1063,edad 50
06791,Tandil,58,483,560,1043,edad 50
06791,Tandil,59,418,484,902,edad 50
06791,Tandil,60,522,503,1025,edad 60
06791,Tandil,61,451,480,931,edad 60
06791,Tandil,62,452,466,918,edad 60
06791,Tandil,63,437,478,915,edad 60
06791,Tandil,64,392,445,837,edad 60
06791,Tandil,65,388,513,901,edad 60
06791,Tandil,66,374,388,762,edad 60
06791,Tandil,67,384,403,787,edad 60
06791,Tandil,68,353,431,784,edad 60
06791,Tandil,69,339,464,803,edad 60
06791,Tandil,70,387,482,869,edad 70
06791,Tandil,71,370,439,809,edad 70
06791,Tandil,72,309,434,743,edad 70
06791,Tandil,73,313,442,755,edad 70
06791,Tandil,74,283,445,728,edad 70
06791,Tandil,75,252,414,666,edad 70
06791,Tandil,76,243,380,623,edad 70
06791,Tandil,77,224,355,579,edad 70
06791,Tandil,78,206,341,547,edad 70
06791,Tandil,79,161,318,479,edad 70
06791,Tandil,80,165,307,472,edad 80
06791,Tandil,81,108,247,355,edad 80
06791,Tandil,82,123,216,339,edad 80
06791,Tandil,83,96,236,332,edad 80
06791,Tandil,84,79,207,286,edad 80
06791,Tandil,85,69,166,235,edad 80
06791,Tandil,86,67,152,219,edad 80
06791,Tandil,87,38,122,160,edad 80
06791,Tandil,88,40,117,157,edad 80
06791,Tandil,89,32,97,129,edad 80
06791,Tandil,90,25,68,93,edad 90
06791,Tandil,91,14,66,80,edad 90
06791,Tandil,92,17,47,64,edad 90
06791,Tandil,93,7,39,46,edad 90
06791,Tandil,94,8,24,32,edad 90
06791,Tandil,95,7,16,23,edad 90
06791,Tandil,96,3,20,23,edad 90
06791,Tandil,97,3,9,12,edad 90
06791,Tandil,98,2,3,5,edad 90
06791,Tandil,99,1,8,9,edad 90
06798,Tapalqué,0,70,81,151,edad 0
06798,Tapalqué,1,68,64,132,edad 0
06798,Tapalqué,2,81,74,155,edad 0
06798,Tapalqué,3,65,65,130,edad 0
06798,Tapalqué,4,63,74,137,edad 0
06798,Tapalqué,5,79,84,163,edad 0
06798,Tapalqué,6,70,88,158,edad 0
06798,Tapalqué,7,72,55,127,edad 0
06798,Tapalqué,8,70,62,132,edad 0
06798,Tapalqué,9,90,60,150,edad 0
06798,Tapalqué,10,78,64,142,edad 10
06798,Tapalqué,11,86,88,174,edad 10
06798,Tapalqué,12,65,80,145,edad 10
06798,Tapalqué,13,66,60,126,edad 10
06798,Tapalqué,14,70,76,146,edad 10
06798,Tapalqué,15,58,75,133,edad 10
06798,Tapalqué,16,74,60,134,edad 10
06798,Tapalqué,17,70,70,140,edad 10
06798,Tapalqué,18,75,64,139,edad 10
06798,Tapalqué,19,54,61,115,edad 10
06798,Tapalqué,20,59,55,114,edad 20
06798,Tapalqué,21,71,45,116,edad 20
06798,Tapalqué,22,50,56,106,edad 20
06798,Tapalqué,23,52,51,103,edad 20
06798,Tapalqué,24,47,66,113,edad 20
06798,Tapalqué,25,63,54,117,edad 20
06798,Tapalqué,26,43,48,91,edad 20
06798,Tapalqué,27,64,51,115,edad 20
06798,Tapalqué,28,56,56,112,edad 20
06798,Tapalqué,29,55,64,119,edad 20
06798,Tapalqué,30,63,54,117,edad 30
06798,Tapalqué,31,42,62,104,edad 30
06798,Tapalqué,32,58,46,104,edad 30
06798,Tapalqué,33,57,48,105,edad 30
06798,Tapalqué,34,49,59,108,edad 30
06798,Tapalqué,35,52,46,98,edad 30
06798,Tapalqué,36,47,58,105,edad 30
06798,Tapalqué,37,61,52,113,edad 30
06798,Tapalqué,38,53,45,98,edad 30
06798,Tapalqué,39,43,57,100,edad 30
06798,Tapalqué,40,48,53,101,edad 40
06798,Tapalqué,41,48,41,89,edad 40
06798,Tapalqué,42,70,46,116,edad 40
06798,Tapalqué,43,49,50,99,edad 40
06798,Tapalqué,44,37,56,93,edad 40
06798,Tapalqué,45,50,64,114,edad 40
06798,Tapalqué,46,49,56,105,edad 40
06798,Tapalqué,47,48,69,117,edad 40
06798,Tapalqué,48,61,43,104,edad 40
06798,Tapalqué,49,52,40,92,edad 40
06798,Tapalqué,50,53,40,93,edad 50
06798,Tapalqué,51,44,43,87,edad 50
06798,Tapalqué,52,47,52,99,edad 50
06798,Tapalqué,53,51,44,95,edad 50
06798,Tapalqué,54,50,38,88,edad 50
06798,Tapalqué,55,35,43,78,edad 50
06798,Tapalqué,56,37,52,89,edad 50
06798,Tapalqué,57,32,45,77,edad 50
06798,Tapalqué,58,38,40,78,edad 50
06798,Tapalqué,59,35,35,70,edad 50
06798,Tapalqué,60,37,25,62,edad 60
06798,Tapalqué,61,36,28,64,edad 60
06798,Tapalqué,62,42,29,71,edad 60
06798,Tapalqué,63,28,29,57,edad 60
06798,Tapalqué,64,46,43,89,edad 60
06798,Tapalqué,65,44,38,82,edad 60
06798,Tapalqué,66,35,26,61,edad 60
06798,Tapalqué,67,28,32,60,edad 60
06798,Tapalqué,68,32,36,68,edad 60
06798,Tapalqué,69,39,29,68,edad 60
06798,Tapalqué,70,33,33,66,edad 70
06798,Tapalqué,71,31,38,69,edad 70
06798,Tapalqué,72,24,34,58,edad 70
06798,Tapalqué,73,27,30,57,edad 70
06798,Tapalqué,74,28,27,55,edad 70
06798,Tapalqué,75,28,32,60,edad 70
06798,Tapalqué,76,18,24,42,edad 70
06798,Tapalqué,77,11,22,33,edad 70
06798,Tapalqué,78,17,24,41,edad 70
06798,Tapalqué,79,12,23,35,edad 70
06798,Tapalqué,80,16,22,38,edad 80
06798,Tapalqué,81,9,16,25,edad 80
06798,Tapalqué,82,12,16,28,edad 80
06798,Tapalqué,83,8,11,19,edad 80
06798,Tapalqué,84,8,7,15,edad 80
06798,Tapalqué,85,5,15,20,edad 80
06798,Tapalqué,86,8,10,18,edad 80
06798,Tapalqué,87,7,11,18,edad 80
06798,Tapalqué,88,6,7,13,edad 80
06798,Tapalqué,89,2,5,7,edad 80
06798,Tapalqué,90,0,4,4,edad 90
06798,Tapalqué,91,1,8,9,edad 90
06798,Tapalqué,92,1,3,4,edad 90
06798,Tapalqué,93,0,2,2,edad 90
06798,Tapalqué,94,1,1,2,edad 90
06798,Tapalqué,95,0,1,1,edad 90
06798,Tapalqué,96,1,0,1,edad 90
06798,Tapalqué,97,1,1,2,edad 90
06798,Tapalqué,99,0,1,1,edad 90
06812,Tordillo,0,17,14,31,edad 0
06812,Tordillo,1,17,15,32,edad 0
06812,Tordillo,2,23,24,47,edad 0
06812,Tordillo,3,23,17,40,edad 0
06812,Tordillo,4,13,19,32,edad 0
06812,Tordillo,5,14,16,30,edad 0
06812,Tordillo,6,23,15,38,edad 0
06812,Tordillo,7,19,12,31,edad 0
06812,Tordillo,8,20,25,45,edad 0
06812,Tordillo,9,12,24,36,edad 0
06812,Tordillo,10,23,19,42,edad 10
06812,Tordillo,11,21,22,43,edad 10
06812,Tordillo,12,21,12,33,edad 10
06812,Tordillo,13,21,18,39,edad 10
06812,Tordillo,14,16,15,31,edad 10
06812,Tordillo,15,19,12,31,edad 10
06812,Tordillo,16,20,14,34,edad 10
06812,Tordillo,17,14,13,27,edad 10
06812,Tordillo,18,8,16,24,edad 10
06812,Tordillo,19,16,8,24,edad 10
06812,Tordillo,20,11,13,24,edad 20
06812,Tordillo,21,13,10,23,edad 20
06812,Tordillo,22,11,19,30,edad 20
06812,Tordillo,23,12,14,26,edad 20
06812,Tordillo,24,10,10,20,edad 20
06812,Tordillo,25,14,6,20,edad 20
06812,Tordillo,26,8,15,23,edad 20
06812,Tordillo,27,14,5,19,edad 20
06812,Tordillo,28,14,11,25,edad 20
06812,Tordillo,29,14,13,27,edad 20
06812,Tordillo,30,14,16,30,edad 30
06812,Tordillo,31,11,11,22,edad 30
06812,Tordillo,32,7,14,21,edad 30
06812,Tordillo,33,13,10,23,edad 30
06812,Tordillo,34,9,6,15,edad 30
06812,Tordillo,35,9,13,22,edad 30
06812,Tordillo,36,12,14,26,edad 30
06812,Tordillo,37,18,12,30,edad 30
06812,Tordillo,38,16,8,24,edad 30
06812,Tordillo,39,13,13,26,edad 30
06812,Tordillo,40,10,13,23,edad 40
06812,Tordillo,41,12,16,28,edad 40
06812,Tordillo,42,9,10,19,edad 40
06812,Tordillo,43,7,8,15,edad 40
06812,Tordillo,44,12,10,22,edad 40
06812,Tordillo,45,19,7,26,edad 40
06812,Tordillo,46,9,12,21,edad 40
06812,Tordillo,47,10,11,21,edad 40
06812,Tordillo,48,7,6,13,edad 40
06812,Tordillo,49,13,8,21,edad 40
06812,Tordillo,50,5,5,10,edad 50
06812,Tordillo,51,12,4,16,edad 50
06812,Tordillo,52,8,3,11,edad 50
06812,Tordillo,53,9,8,17,edad 50
06812,Tordillo,54,15,6,21,edad 50
06812,Tordillo,55,6,8,14,edad 50
06812,Tordillo,56,11,4,15,edad 50
06812,Tordillo,57,11,6,17,edad 50
06812,Tordillo,58,6,1,7,edad 50
06812,Tordillo,59,8,4,12,edad 50
06812,Tordillo,60,9,12,21,edad 60
06812,Tordillo,61,14,10,24,edad 60
06812,Tordillo,62,11,4,15,edad 60
06812,Tordillo,63,8,4,12,edad 60
06812,Tordillo,64,6,8,14,edad 60
06812,Tordillo,65,4,6,10,edad 60
06812,Tordillo,66,5,4,9,edad 60
06812,Tordillo,67,2,6,8,edad 60
06812,Tordillo,68,7,5,12,edad 60
06812,Tordillo,69,5,6,11,edad 60
06812,Tordillo,70,5,4,9,edad 70
06812,Tordillo,71,7,4,11,edad 70
06812,Tordillo,72,5,6,11,edad 70
06812,Tordillo,73,1,6,7,edad 70
06812,Tordillo,74,3,1,4,edad 70
06812,Tordillo,75,2,4,6,edad 70
06812,Tordillo,76,2,5,7,edad 70
06812,Tordillo,77,1,3,4,edad 70
06812,Tordillo,78,4,2,6,edad 70
06812,Tordillo,79,3,1,4,edad 70
06812,Tordillo,80,1,2,3,edad 80
06812,Tordillo,81,1,2,3,edad 80
06812,Tordillo,82,2,1,3,edad 80
06812,Tordillo,83,0,2,2,edad 80
06812,Tordillo,84,2,1,3,edad 80
06812,Tordillo,86,1,2,3,edad 80
06812,Tordillo,87,0,1,1,edad 80
06812,Tordillo,90,0,1,1,edad 90
06812,Tordillo,92,0,1,1,edad 90
06812,Tordillo,98,0,2,2,edad 90
06819,Tornquist,0,87,87,174,edad 0
06819,Tornquist,1,81,71,152,edad 0
06819,Tornquist,2,75,86,161,edad 0
06819,Tornquist,3,72,93,165,edad 0
06819,Tornquist,4,77,83,160,edad 0
06819,Tornquist,5,98,75,173,edad 0
06819,Tornquist,6,84,109,193,edad 0
06819,Tornquist,7,82,82,164,edad 0
06819,Tornquist,8,105,83,188,edad 0
06819,Tornquist,9,100,96,196,edad 0
06819,Tornquist,10,94,99,193,edad 10
06819,Tornquist,11,108,98,206,edad 10
06819,Tornquist,12,122,105,227,edad 10
06819,Tornquist,13,118,93,211,edad 10
06819,Tornquist,14,115,120,235,edad 10
06819,Tornquist,15,119,109,228,edad 10
06819,Tornquist,16,111,104,215,edad 10
06819,Tornquist,17,91,125,216,edad 10
06819,Tornquist,18,99,79,178,edad 10
06819,Tornquist,19,96,86,182,edad 10
06819,Tornquist,20,104,93,197,edad 20
06819,Tornquist,21,86,71,157,edad 20
06819,Tornquist,22,67,64,131,edad 20
06819,Tornquist,23,92,67,159,edad 20
06819,Tornquist,24,84,66,150,edad 20
06819,Tornquist,25,80,65,145,edad 20
06819,Tornquist,26,72,63,135,edad 20
06819,Tornquist,27,81,74,155,edad 20
06819,Tornquist,28,80,78,158,edad 20
06819,Tornquist,29,59,63,122,edad 20
06819,Tornquist,30,82,58,140,edad 30
06819,Tornquist,31,64,69,133,edad 30
06819,Tornquist,32,70,64,134,edad 30
06819,Tornquist,33,81,59,140,edad 30
06819,Tornquist,34,60,84,144,edad 30
06819,Tornquist,35,66,72,138,edad 30
06819,Tornquist,36,86,81,167,edad 30
06819,Tornquist,37,82,82,164,edad 30
06819,Tornquist,38,81,80,161,edad 30
06819,Tornquist,39,73,80,153,edad 30
06819,Tornquist,40,79,88,167,edad 40
06819,Tornquist,41,75,78,153,edad 40
06819,Tornquist,42,85,61,146,edad 40
06819,Tornquist,43,78,76,154,edad 40
06819,Tornquist,44,72,68,140,edad 40
06819,Tornquist,45,84,70,154,edad 40
06819,Tornquist,46,65,74,139,edad 40
06819,Tornquist,47,71,64,135,edad 40
06819,Tornquist,48,63,67,130,edad 40
06819,Tornquist,49,55,77,132,edad 40
06819,Tornquist,50,73,56,129,edad 50
06819,Tornquist,51,76,67,143,edad 50
06819,Tornquist,52,83,82,165,edad 50
06819,Tornquist,53,74,80,154,edad 50
06819,Tornquist,54,75,68,143,edad 50
06819,Tornquist,55,56,67,123,edad 50
06819,Tornquist,56,65,61,126,edad 50
06819,Tornquist,57,66,64,130,edad 50
06819,Tornquist,58,69,48,117,edad 50
06819,Tornquist,59,55,59,114,edad 50
06819,Tornquist,60,67,69,136,edad 60
06819,Tornquist,61,51,32,83,edad 60
06819,Tornquist,62,49,69,118,edad 60
06819,Tornquist,63,59,48,107,edad 60
06819,Tornquist,64,52,47,99,edad 60
06819,Tornquist,65,51,45,96,edad 60
06819,Tornquist,66,60,57,117,edad 60
06819,Tornquist,67,44,49,93,edad 60
06819,Tornquist,68,60,46,106,edad 60
06819,Tornquist,69,35,43,78,edad 60
06819,Tornquist,70,50,56,106,edad 70
06819,Tornquist,71,43,54,97,edad 70
06819,Tornquist,72,42,49,91,edad 70
06819,Tornquist,73,51,57,108,edad 70
06819,Tornquist,74,32,52,84,edad 70
06819,Tornquist,75,47,42,89,edad 70
06819,Tornquist,76,25,42,67,edad 70
06819,Tornquist,77,22,34,56,edad 70
06819,Tornquist,78,26,34,60,edad 70
06819,Tornquist,79,22,32,54,edad 70
06819,Tornquist,80,14,27,41,edad 80
06819,Tornquist,81,15,21,36,edad 80
06819,Tornquist,82,11,25,36,edad 80
06819,Tornquist,83,9,22,31,edad 80
06819,Tornquist,84,10,21,31,edad 80
06819,Tornquist,85,10,18,28,edad 80
06819,Tornquist,86,17,19,36,edad 80
06819,Tornquist,87,7,16,23,edad 80
06819,Tornquist,88,2,10,12,edad 80
06819,Tornquist,89,6,9,15,edad 80
06819,Tornquist,90,5,6,11,edad 90
06819,Tornquist,91,0,4,4,edad 90
06819,Tornquist,93,3,5,8,edad 90
06819,Tornquist,94,0,3,3,edad 90
06819,Tornquist,95,0,1,1,edad 90
06819,Tornquist,99,1,0,1,edad 90
06826,Trenque Lauquen,0,341,359,700,edad 0
06826,Trenque Lauquen,1,324,356,680,edad 0
06826,Trenque Lauquen,2,389,378,767,edad 0
06826,Trenque Lauquen,3,408,365,773,edad 0
06826,Trenque Lauquen,4,386,343,729,edad 0
06826,Trenque Lauquen,5,372,372,744,edad 0
06826,Trenque Lauquen,6,375,369,744,edad 0
06826,Trenque Lauquen,7,353,360,713,edad 0
06826,Trenque Lauquen,8,338,352,690,edad 0
06826,Trenque Lauquen,9,407,383,790,edad 0
06826,Trenque Lauquen,10,396,402,798,edad 10
06826,Trenque Lauquen,11,397,417,814,edad 10
06826,Trenque Lauquen,12,391,383,774,edad 10
06826,Trenque Lauquen,13,415,358,773,edad 10
06826,Trenque Lauquen,14,350,358,708,edad 10
06826,Trenque Lauquen,15,383,368,751,edad 10
06826,Trenque Lauquen,16,368,359,727,edad 10
06826,Trenque Lauquen,17,358,327,685,edad 10
06826,Trenque Lauquen,18,334,316,650,edad 10
06826,Trenque Lauquen,19,314,267,581,edad 10
06826,Trenque Lauquen,20,321,266,587,edad 20
06826,Trenque Lauquen,21,295,258,553,edad 20
06826,Trenque Lauquen,22,270,256,526,edad 20
06826,Trenque Lauquen,23,284,255,539,edad 20
06826,Trenque Lauquen,24,252,256,508,edad 20
06826,Trenque Lauquen,25,269,259,528,edad 20
06826,Trenque Lauquen,26,287,336,623,edad 20
06826,Trenque Lauquen,27,277,291,568,edad 20
06826,Trenque Lauquen,28,289,265,554,edad 20
06826,Trenque Lauquen,29,258,276,534,edad 20
06826,Trenque Lauquen,30,283,296,579,edad 30
06826,Trenque Lauquen,31,257,272,529,edad 30
06826,Trenque Lauquen,32,246,236,482,edad 30
06826,Trenque Lauquen,33,243,255,498,edad 30
06826,Trenque Lauquen,34,256,250,506,edad 30
06826,Trenque Lauquen,35,262,222,484,edad 30
06826,Trenque Lauquen,36,261,277,538,edad 30
06826,Trenque Lauquen,37,257,257,514,edad 30
06826,Trenque Lauquen,38,260,290,550,edad 30
06826,Trenque Lauquen,39,231,232,463,edad 30
06826,Trenque Lauquen,40,249,289,538,edad 40
06826,Trenque Lauquen,41,255,263,518,edad 40
06826,Trenque Lauquen,42,215,226,441,edad 40
06826,Trenque Lauquen,43,266,223,489,edad 40
06826,Trenque Lauquen,44,229,223,452,edad 40
06826,Trenque Lauquen,45,228,236,464,edad 40
06826,Trenque Lauquen,46,237,243,480,edad 40
06826,Trenque Lauquen,47,229,208,437,edad 40
06826,Trenque Lauquen,48,216,209,425,edad 40
06826,Trenque Lauquen,49,226,199,425,edad 40
06826,Trenque Lauquen,50,220,175,395,edad 50
06826,Trenque Lauquen,51,216,205,421,edad 50
06826,Trenque Lauquen,52,193,212,405,edad 50
06826,Trenque Lauquen,53,197,248,445,edad 50
06826,Trenque Lauquen,54,211,203,414,edad 50
06826,Trenque Lauquen,55,196,192,388,edad 50
06826,Trenque Lauquen,56,209,217,426,edad 50
06826,Trenque Lauquen,57,180,197,377,edad 50
06826,Trenque Lauquen,58,184,187,371,edad 50
06826,Trenque Lauquen,59,163,163,326,edad 50
06826,Trenque Lauquen,60,175,175,350,edad 60
06826,Trenque Lauquen,61,137,158,295,edad 60
06826,Trenque Lauquen,62,155,171,326,edad 60
06826,Trenque Lauquen,63,129,146,275,edad 60
06826,Trenque Lauquen,64,148,153,301,edad 60
06826,Trenque Lauquen,65,147,154,301,edad 60
06826,Trenque Lauquen,66,130,145,275,edad 60
06826,Trenque Lauquen,67,133,145,278,edad 60
06826,Trenque Lauquen,68,123,173,296,edad 60
06826,Trenque Lauquen,69,128,153,281,edad 60
06826,Trenque Lauquen,70,129,152,281,edad 70
06826,Trenque Lauquen,71,118,145,263,edad 70
06826,Trenque Lauquen,72,131,167,298,edad 70
06826,Trenque Lauquen,73,112,137,249,edad 70
06826,Trenque Lauquen,74,101,146,247,edad 70
06826,Trenque Lauquen,75,98,125,223,edad 70
06826,Trenque Lauquen,76,85,133,218,edad 70
06826,Trenque Lauquen,77,83,113,196,edad 70
06826,Trenque Lauquen,78,61,104,165,edad 70
06826,Trenque Lauquen,79,66,78,144,edad 70
06826,Trenque Lauquen,80,78,100,178,edad 80
06826,Trenque Lauquen,81,49,77,126,edad 80
06826,Trenque Lauquen,82,39,68,107,edad 80
06826,Trenque Lauquen,83,33,62,95,edad 80
06826,Trenque Lauquen,84,32,67,99,edad 80
06826,Trenque Lauquen,85,31,64,95,edad 80
06826,Trenque Lauquen,86,16,43,59,edad 80
06826,Trenque Lauquen,87,23,38,61,edad 80
06826,Trenque Lauquen,88,18,31,49,edad 80
06826,Trenque Lauquen,89,16,21,37,edad 80
06826,Trenque Lauquen,90,10,22,32,edad 90
06826,Trenque Lauquen,91,6,29,35,edad 90
06826,Trenque Lauquen,92,6,13,19,edad 90
06826,Trenque Lauquen,93,0,6,6,edad 90
06826,Trenque Lauquen,94,0,11,11,edad 90
06826,Trenque Lauquen,95,1,7,8,edad 90
06826,Trenque Lauquen,96,0,4,4,edad 90
06826,Trenque Lauquen,97,1,0,1,edad 90
06826,Trenque Lauquen,98,0,2,2,edad 90
06826,Trenque Lauquen,99,2,0,2,edad 90
06833,Tres Arroyos,0,438,399,837,edad 0
06833,Tres Arroyos,1,423,361,784,edad 0
06833,Tres Arroyos,2,474,446,920,edad 0
06833,Tres Arroyos,3,386,431,817,edad 0
06833,Tres Arroyos,4,461,426,887,edad 0
06833,Tres Arroyos,5,463,429,892,edad 0
06833,Tres Arroyos,6,469,436,905,edad 0
06833,Tres Arroyos,7,507,435,942,edad 0
06833,Tres Arroyos,8,497,460,957,edad 0
06833,Tres Arroyos,9,487,468,955,edad 0
06833,Tres Arroyos,10,519,506,1025,edad 10
06833,Tres Arroyos,11,505,489,994,edad 10
06833,Tres Arroyos,12,485,472,957,edad 10
06833,Tres Arroyos,13,522,471,993,edad 10
06833,Tres Arroyos,14,534,496,1030,edad 10
06833,Tres Arroyos,15,508,479,987,edad 10
06833,Tres Arroyos,16,526,490,1016,edad 10
06833,Tres Arroyos,17,459,452,911,edad 10
06833,Tres Arroyos,18,413,355,768,edad 10
06833,Tres Arroyos,19,400,337,737,edad 10
06833,Tres Arroyos,20,373,338,711,edad 20
06833,Tres Arroyos,21,392,418,810,edad 20
06833,Tres Arroyos,22,385,371,756,edad 20
06833,Tres Arroyos,23,382,375,757,edad 20
06833,Tres Arroyos,24,387,370,757,edad 20
06833,Tres Arroyos,25,363,314,677,edad 20
06833,Tres Arroyos,26,345,333,678,edad 20
06833,Tres Arroyos,27,322,338,660,edad 20
06833,Tres Arroyos,28,308,342,650,edad 20
06833,Tres Arroyos,29,331,346,677,edad 20
06833,Tres Arroyos,30,351,353,704,edad 30
06833,Tres Arroyos,31,317,352,669,edad 30
06833,Tres Arroyos,32,314,375,689,edad 30
06833,Tres Arroyos,33,312,363,675,edad 30
06833,Tres Arroyos,34,377,363,740,edad 30
06833,Tres Arroyos,35,361,381,742,edad 30
06833,Tres Arroyos,36,398,418,816,edad 30
06833,Tres Arroyos,37,354,393,747,edad 30
06833,Tres Arroyos,38,353,374,727,edad 30
06833,Tres Arroyos,39,340,314,654,edad 30
06833,Tres Arroyos,40,346,372,718,edad 40
06833,Tres Arroyos,41,349,346,695,edad 40
06833,Tres Arroyos,42,328,340,668,edad 40
06833,Tres Arroyos,43,357,317,674,edad 40
06833,Tres Arroyos,44,306,330,636,edad 40
06833,Tres Arroyos,45,332,348,680,edad 40
06833,Tres Arroyos,46,315,351,666,edad 40
06833,Tres Arroyos,47,334,345,679,edad 40
06833,Tres Arroyos,48,291,326,617,edad 40
06833,Tres Arroyos,49,309,333,642,edad 40
06833,Tres Arroyos,50,350,362,712,edad 50
06833,Tres Arroyos,51,326,367,693,edad 50
06833,Tres Arroyos,52,332,358,690,edad 50
06833,Tres Arroyos,53,330,373,703,edad 50
06833,Tres Arroyos,54,310,374,684,edad 50
06833,Tres Arroyos,55,308,323,631,edad 50
06833,Tres Arroyos,56,311,306,617,edad 50
06833,Tres Arroyos,57,283,311,594,edad 50
06833,Tres Arroyos,58,281,319,600,edad 50
06833,Tres Arroyos,59,271,283,554,edad 50
06833,Tres Arroyos,60,268,300,568,edad 60
06833,Tres Arroyos,61,304,288,592,edad 60
06833,Tres Arroyos,62,223,291,514,edad 60
06833,Tres Arroyos,63,240,309,549,edad 60
06833,Tres Arroyos,64,248,266,514,edad 60
06833,Tres Arroyos,65,251,296,547,edad 60
06833,Tres Arroyos,66,195,274,469,edad 60
06833,Tres Arroyos,67,204,251,455,edad 60
06833,Tres Arroyos,68,245,284,529,edad 60
06833,Tres Arroyos,69,211,268,479,edad 60
06833,Tres Arroyos,70,213,286,499,edad 70
06833,Tres Arroyos,71,214,260,474,edad 70
06833,Tres Arroyos,72,212,268,480,edad 70
06833,Tres Arroyos,73,197,308,505,edad 70
06833,Tres Arroyos,74,149,240,389,edad 70
06833,Tres Arroyos,75,178,218,396,edad 70
06833,Tres Arroyos,76,148,243,391,edad 70
06833,Tres Arroyos,77,133,212,345,edad 70
06833,Tres Arroyos,78,144,218,362,edad 70
06833,Tres Arroyos,79,116,201,317,edad 70
06833,Tres Arroyos,80,100,203,303,edad 80
06833,Tres Arroyos,81,110,166,276,edad 80
06833,Tres Arroyos,82,85,157,242,edad 80
06833,Tres Arroyos,83,81,141,222,edad 80
06833,Tres Arroyos,84,61,144,205,edad 80
06833,Tres Arroyos,85,65,116,181,edad 80
06833,Tres Arroyos,86,52,101,153,edad 80
06833,Tres Arroyos,87,33,90,123,edad 80
06833,Tres Arroyos,88,20,79,99,edad 80
06833,Tres Arroyos,89,23,52,75,edad 80
06833,Tres Arroyos,90,16,41,57,edad 90
06833,Tres Arroyos,91,6,41,47,edad 90
06833,Tres Arroyos,92,10,32,42,edad 90
06833,Tres Arroyos,93,3,29,32,edad 90
06833,Tres Arroyos,94,2,14,16,edad 90
06833,Tres Arroyos,95,1,11,12,edad 90
06833,Tres Arroyos,96,3,10,13,edad 90
06833,Tres Arroyos,97,1,4,5,edad 90
06833,Tres Arroyos,98,0,2,2,edad 90
06847,Tres Lomas,0,60,63,123,edad 0
06847,Tres Lomas,1,57,51,108,edad 0
06847,Tres Lomas,2,55,64,119,edad 0
06847,Tres Lomas,3,62,57,119,edad 0
06847,Tres Lomas,4,63,63,126,edad 0
06847,Tres Lomas,5,61,54,115,edad 0
06847,Tres Lomas,6,68,58,126,edad 0
06847,Tres Lomas,7,75,52,127,edad 0
06847,Tres Lomas,8,58,56,114,edad 0
06847,Tres Lomas,9,67,73,140,edad 0
06847,Tres Lomas,10,71,71,142,edad 10
06847,Tres Lomas,11,65,56,121,edad 10
06847,Tres Lomas,12,67,64,131,edad 10
06847,Tres Lomas,13,68,61,129,edad 10
06847,Tres Lomas,14,51,58,109,edad 10
06847,Tres Lomas,15,66,62,128,edad 10
06847,Tres Lomas,16,68,65,133,edad 10
06847,Tres Lomas,17,57,70,127,edad 10
06847,Tres Lomas,18,58,45,103,edad 10
06847,Tres Lomas,19,53,59,112,edad 10
06847,Tres Lomas,20,35,46,81,edad 20
06847,Tres Lomas,21,49,45,94,edad 20
06847,Tres Lomas,22,59,41,100,edad 20
06847,Tres Lomas,23,54,41,95,edad 20
06847,Tres Lomas,24,61,47,108,edad 20
06847,Tres Lomas,25,49,35,84,edad 20
06847,Tres Lomas,26,56,48,104,edad 20
06847,Tres Lomas,27,44,34,78,edad 20
06847,Tres Lomas,28,61,55,116,edad 20
06847,Tres Lomas,29,40,46,86,edad 20
06847,Tres Lomas,30,52,57,109,edad 30
06847,Tres Lomas,31,34,32,66,edad 30
06847,Tres Lomas,32,40,33,73,edad 30
06847,Tres Lomas,33,54,36,90,edad 30
06847,Tres Lomas,34,45,36,81,edad 30
06847,Tres Lomas,35,29,52,81,edad 30
06847,Tres Lomas,36,43,56,99,edad 30
06847,Tres Lomas,37,36,41,77,edad 30
06847,Tres Lomas,38,51,43,94,edad 30
06847,Tres Lomas,39,31,41,72,edad 30
06847,Tres Lomas,40,55,44,99,edad 40
06847,Tres Lomas,41,55,40,95,edad 40
06847,Tres Lomas,42,42,42,84,edad 40
06847,Tres Lomas,43,30,48,78,edad 40
06847,Tres Lomas,44,41,44,85,edad 40
06847,Tres Lomas,45,49,41,90,edad 40
06847,Tres Lomas,46,46,44,90,edad 40
06847,Tres Lomas,47,39,40,79,edad 40
06847,Tres Lomas,48,33,33,66,edad 40
06847,Tres Lomas,49,38,42,80,edad 40
06847,Tres Lomas,50,45,44,89,edad 50
06847,Tres Lomas,51,62,48,110,edad 50
06847,Tres Lomas,52,37,40,77,edad 50
06847,Tres Lomas,53,46,70,116,edad 50
06847,Tres Lomas,54,39,37,76,edad 50
06847,Tres Lomas,55,45,50,95,edad 50
06847,Tres Lomas,56,49,40,89,edad 50
06847,Tres Lomas,57,42,45,87,edad 50
06847,Tres Lomas,58,38,37,75,edad 50
06847,Tres Lomas,59,49,36,85,edad 50
06847,Tres Lomas,60,42,33,75,edad 60
06847,Tres Lomas,61,24,37,61,edad 60
06847,Tres Lomas,62,29,34,63,edad 60
06847,Tres Lomas,63,34,29,63,edad 60
06847,Tres Lomas,64,34,31,65,edad 60
06847,Tres Lomas,65,38,40,78,edad 60
06847,Tres Lomas,66,33,38,71,edad 60
06847,Tres Lomas,67,29,29,58,edad 60
06847,Tres Lomas,68,29,32,61,edad 60
06847,Tres Lomas,69,31,25,56,edad 60
06847,Tres Lomas,70,36,31,67,edad 70
06847,Tres Lomas,71,32,29,61,edad 70
06847,Tres Lomas,72,27,42,69,edad 70
06847,Tres Lomas,73,26,32,58,edad 70
06847,Tres Lomas,74,32,32,64,edad 70
06847,Tres Lomas,75,23,28,51,edad 70
06847,Tres Lomas,76,23,34,57,edad 70
06847,Tres Lomas,77,19,24,43,edad 70
06847,Tres Lomas,78,14,28,42,edad 70
06847,Tres Lomas,79,19,19,38,edad 70
06847,Tres Lomas,80,15,18,33,edad 80
06847,Tres Lomas,81,18,13,31,edad 80
06847,Tres Lomas,82,13,25,38,edad 80
06847,Tres Lomas,83,9,13,22,edad 80
06847,Tres Lomas,84,9,19,28,edad 80
06847,Tres Lomas,85,2,15,17,edad 80
06847,Tres Lomas,86,7,15,22,edad 80
06847,Tres Lomas,87,2,14,16,edad 80
06847,Tres Lomas,88,3,7,10,edad 80
06847,Tres Lomas,89,2,5,7,edad 80
06847,Tres Lomas,90,4,4,8,edad 90
06847,Tres Lomas,91,2,2,4,edad 90
06847,Tres Lomas,92,2,9,11,edad 90
06847,Tres Lomas,93,2,0,2,edad 90
06847,Tres Lomas,94,1,0,1,edad 90
06847,Tres Lomas,95,0,1,1,edad 90
06847,Tres Lomas,97,0,1,1,edad 90
06847,Tres Lomas,98,1,0,1,edad 90
06854,25 de Mayo,0,274,292,566,edad 0
06854,25 de Mayo,1,253,239,492,edad 0
06854,25 de Mayo,2,316,286,602,edad 0
06854,25 de Mayo,3,263,241,504,edad 0
06854,25 de Mayo,4,275,264,539,edad 0
06854,25 de Mayo,5,291,260,551,edad 0
06854,25 de Mayo,6,266,292,558,edad 0
06854,25 de Mayo,7,270,277,547,edad 0
06854,25 de Mayo,8,305,295,600,edad 0
06854,25 de Mayo,9,337,292,629,edad 0
06854,25 de Mayo,10,363,327,690,edad 10
06854,25 de Mayo,11,322,316,638,edad 10
06854,25 de Mayo,12,272,289,561,edad 10
06854,25 de Mayo,13,308,294,602,edad 10
06854,25 de Mayo,14,298,298,596,edad 10
06854,25 de Mayo,15,272,274,546,edad 10
06854,25 de Mayo,16,283,258,541,edad 10
06854,25 de Mayo,17,270,266,536,edad 10
06854,25 de Mayo,18,249,248,497,edad 10
06854,25 de Mayo,19,254,243,497,edad 10
06854,25 de Mayo,20,296,265,561,edad 20
06854,25 de Mayo,21,253,260,513,edad 20
06854,25 de Mayo,22,261,248,509,edad 20
06854,25 de Mayo,23,249,227,476,edad 20
06854,25 de Mayo,24,211,233,444,edad 20
06854,25 de Mayo,25,241,243,484,edad 20
06854,25 de Mayo,26,206,211,417,edad 20
06854,25 de Mayo,27,215,218,433,edad 20
06854,25 de Mayo,28,217,204,421,edad 20
06854,25 de Mayo,29,197,204,401,edad 20
06854,25 de Mayo,30,227,228,455,edad 30
06854,25 de Mayo,31,193,192,385,edad 30
06854,25 de Mayo,32,206,224,430,edad 30
06854,25 de Mayo,33,220,184,404,edad 30
06854,25 de Mayo,34,174,197,371,edad 30
06854,25 de Mayo,35,189,203,392,edad 30
06854,25 de Mayo,36,219,226,445,edad 30
06854,25 de Mayo,37,215,204,419,edad 30
06854,25 de Mayo,38,208,215,423,edad 30
06854,25 de Mayo,39,184,192,376,edad 30
06854,25 de Mayo,40,213,238,451,edad 40
06854,25 de Mayo,41,201,214,415,edad 40
06854,25 de Mayo,42,222,215,437,edad 40
06854,25 de Mayo,43,192,201,393,edad 40
06854,25 de Mayo,44,164,163,327,edad 40
06854,25 de Mayo,45,191,200,391,edad 40
06854,25 de Mayo,46,167,219,386,edad 40
06854,25 de Mayo,47,202,178,380,edad 40
06854,25 de Mayo,48,204,183,387,edad 40
06854,25 de Mayo,49,183,188,371,edad 40
06854,25 de Mayo,50,162,189,351,edad 50
06854,25 de Mayo,51,200,207,407,edad 50
06854,25 de Mayo,52,215,202,417,edad 50
06854,25 de Mayo,53,197,218,415,edad 50
06854,25 de Mayo,54,187,187,374,edad 50
06854,25 de Mayo,55,192,188,380,edad 50
06854,25 de Mayo,56,198,191,389,edad 50
06854,25 de Mayo,57,190,197,387,edad 50
06854,25 de Mayo,58,170,175,345,edad 50
06854,25 de Mayo,59,138,175,313,edad 50
06854,25 de Mayo,60,170,188,358,edad 60
06854,25 de Mayo,61,147,141,288,edad 60
06854,25 de Mayo,62,166,177,343,edad 60
06854,25 de Mayo,63,159,181,340,edad 60
06854,25 de Mayo,64,136,171,307,edad 60
06854,25 de Mayo,65,150,169,319,edad 60
06854,25 de Mayo,66,150,135,285,edad 60
06854,25 de Mayo,67,137,152,289,edad 60
06854,25 de Mayo,68,141,167,308,edad 60
06854,25 de Mayo,69,125,148,273,edad 60
06854,25 de Mayo,70,123,152,275,edad 70
06854,25 de Mayo,71,147,183,330,edad 70
06854,25 de Mayo,72,139,159,298,edad 70
06854,25 de Mayo,73,112,154,266,edad 70
06854,25 de Mayo,74,113,158,271,edad 70
06854,25 de Mayo,75,105,153,258,edad 70
06854,25 de Mayo,76,111,141,252,edad 70
06854,25 de Mayo,77,109,142,251,edad 70
06854,25 de Mayo,78,103,119,222,edad 70
06854,25 de Mayo,79,71,119,190,edad 70
06854,25 de Mayo,80,70,102,172,edad 80
06854,25 de Mayo,81,48,111,159,edad 80
06854,25 de Mayo,82,64,85,149,edad 80
06854,25 de Mayo,83,48,100,148,edad 80
06854,25 de Mayo,84,38,79,117,edad 80
06854,25 de Mayo,85,43,63,106,edad 80
06854,25 de Mayo,86,38,70,108,edad 80
06854,25 de Mayo,87,21,65,86,edad 80
06854,25 de Mayo,88,24,54,78,edad 80
06854,25 de Mayo,89,26,44,70,edad 80
06854,25 de Mayo,90,18,39,57,edad 90
06854,25 de Mayo,91,12,30,42,edad 90
06854,25 de Mayo,92,3,23,26,edad 90
06854,25 de Mayo,93,7,11,18,edad 90
06854,25 de Mayo,94,4,18,22,edad 90
06854,25 de Mayo,95,6,4,10,edad 90
06854,25 de Mayo,96,2,3,5,edad 90
06854,25 de Mayo,97,1,2,3,edad 90
06854,25 de Mayo,98,0,5,5,edad 90
06854,25 de Mayo,99,0,3,3,edad 90
06868,Villa Gesell,0,246,234,480,edad 0
06868,Villa Gesell,1,229,155,384,edad 0
06868,Villa Gesell,2,235,248,483,edad 0
06868,Villa Gesell,3,221,222,443,edad 0
06868,Villa Gesell,4,218,234,452,edad 0
06868,Villa Gesell,5,208,232,440,edad 0
06868,Villa Gesell,6,225,221,446,edad 0
06868,Villa Gesell,7,212,204,416,edad 0
06868,Villa Gesell,8,194,208,402,edad 0
06868,Villa Gesell,9,236,246,482,edad 0
06868,Villa Gesell,10,255,196,451,edad 10
06868,Villa Gesell,11,253,217,470,edad 10
06868,Villa Gesell,12,205,210,415,edad 10
06868,Villa Gesell,13,232,244,476,edad 10
06868,Villa Gesell,14,223,227,450,edad 10
06868,Villa Gesell,15,228,196,424,edad 10
06868,Villa Gesell,16,207,188,395,edad 10
06868,Villa Gesell,17,205,191,396,edad 10
06868,Villa Gesell,18,192,180,372,edad 10
06868,Villa Gesell,19,185,203,388,edad 10
06868,Villa Gesell,20,189,197,386,edad 20
06868,Villa Gesell,21,192,197,389,edad 20
06868,Villa Gesell,22,189,195,384,edad 20
06868,Villa Gesell,23,164,183,347,edad 20
06868,Villa Gesell,24,152,176,328,edad 20
06868,Villa Gesell,25,182,161,343,edad 20
06868,Villa Gesell,26,153,198,351,edad 20
06868,Villa Gesell,27,179,166,345,edad 20
06868,Villa Gesell,28,179,156,335,edad 20
06868,Villa Gesell,29,155,189,344,edad 20
06868,Villa Gesell,30,183,184,367,edad 30
06868,Villa Gesell,31,184,142,326,edad 30
06868,Villa Gesell,32,147,183,330,edad 30
06868,Villa Gesell,33,150,190,340,edad 30
06868,Villa Gesell,34,142,123,265,edad 30
06868,Villa Gesell,35,152,155,307,edad 30
06868,Villa Gesell,36,160,182,342,edad 30
06868,Villa Gesell,37,158,159,317,edad 30
06868,Villa Gesell,38,167,174,341,edad 30
06868,Villa Gesell,39,166,151,317,edad 30
06868,Villa Gesell,40,163,189,352,edad 40
06868,Villa Gesell,41,145,140,285,edad 40
06868,Villa Gesell,42,175,169,344,edad 40
06868,Villa Gesell,43,150,159,309,edad 40
06868,Villa Gesell,44,147,158,305,edad 40
06868,Villa Gesell,45,142,160,302,edad 40
06868,Villa Gesell,46,157,171,328,edad 40
06868,Villa Gesell,47,127,139,266,edad 40
06868,Villa Gesell,48,126,154,280,edad 40
06868,Villa Gesell,49,124,136,260,edad 40
06868,Villa Gesell,50,167,181,348,edad 50
06868,Villa Gesell,51,156,129,285,edad 50
06868,Villa Gesell,52,156,150,306,edad 50
06868,Villa Gesell,53,138,147,285,edad 50
06868,Villa Gesell,54,124,123,247,edad 50
06868,Villa Gesell,55,108,131,239,edad 50
06868,Villa Gesell,56,128,132,260,edad 50
06868,Villa Gesell,57,134,109,243,edad 50
06868,Villa Gesell,58,122,111,233,edad 50
06868,Villa Gesell,59,98,96,194,edad 50
06868,Villa Gesell,60,114,113,227,edad 60
06868,Villa Gesell,61,75,90,165,edad 60
06868,Villa Gesell,62,81,97,178,edad 60
06868,Villa Gesell,63,94,83,177,edad 60
06868,Villa Gesell,64,65,71,136,edad 60
06868,Villa Gesell,65,86,104,190,edad 60
06868,Villa Gesell,66,79,74,153,edad 60
06868,Villa Gesell,67,64,71,135,edad 60
06868,Villa Gesell,68,76,79,155,edad 60
06868,Villa Gesell,69,80,82,162,edad 60
06868,Villa Gesell,70,74,94,168,edad 70
06868,Villa Gesell,71,63,82,145,edad 70
06868,Villa Gesell,72,56,69,125,edad 70
06868,Villa Gesell,73,57,64,121,edad 70
06868,Villa Gesell,74,53,65,118,edad 70
06868,Villa Gesell,75,54,74,128,edad 70
06868,Villa Gesell,76,29,50,79,edad 70
06868,Villa Gesell,77,43,47,90,edad 70
06868,Villa Gesell,78,29,42,71,edad 70
06868,Villa Gesell,79,29,27,56,edad 70
06868,Villa Gesell,80,29,33,62,edad 80
06868,Villa Gesell,81,25,28,53,edad 80
06868,Villa Gesell,82,21,22,43,edad 80
06868,Villa Gesell,83,9,20,29,edad 80
06868,Villa Gesell,84,8,14,22,edad 80
06868,Villa Gesell,85,3,13,16,edad 80
06868,Villa Gesell,86,2,20,22,edad 80
06868,Villa Gesell,87,7,21,28,edad 80
06868,Villa Gesell,88,7,13,20,edad 80
06868,Villa Gesell,89,8,12,20,edad 80
06868,Villa Gesell,90,3,7,10,edad 90
06868,Villa Gesell,91,1,3,4,edad 90
06868,Villa Gesell,92,2,5,7,edad 90
06868,Villa Gesell,93,1,4,5,edad 90
06868,Villa Gesell,94,0,3,3,edad 90
06868,Villa Gesell,95,3,5,8,edad 90
06868,Villa Gesell,96,1,3,4,edad 90
06868,Villa Gesell,97,2,2,4,edad 90
06868,Villa Gesell,99,0,3,3,edad 90
06875,Villarino,0,249,246,495,edad 0
06875,Villarino,1,245,219,464,edad 0
06875,Villarino,2,263,274,537,edad 0
06875,Villarino,3,261,285,546,edad 0
06875,Villarino,4,283,275,558,edad 0
06875,Villarino,5,297,270,567,edad 0
06875,Villarino,6,263,309,572,edad 0
06875,Villarino,7,271,274,545,edad 0
06875,Villarino,8,295,317,612,edad 0
06875,Villarino,9,264,263,527,edad 0
06875,Villarino,10,309,303,612,edad 10
06875,Villarino,11,282,310,592,edad 10
06875,Villarino,12,278,270,548,edad 10
06875,Villarino,13,287,251,538,edad 10
06875,Villarino,14,240,264,504,edad 10
06875,Villarino,15,252,237,489,edad 10
06875,Villarino,16,287,247,534,edad 10
06875,Villarino,17,250,206,456,edad 10
06875,Villarino,18,239,213,452,edad 10
06875,Villarino,19,203,206,409,edad 10
06875,Villarino,20,216,186,402,edad 20
06875,Villarino,21,209,215,424,edad 20
06875,Villarino,22,219,203,422,edad 20
06875,Villarino,23,182,210,392,edad 20
06875,Villarino,24,190,198,388,edad 20
06875,Villarino,25,203,181,384,edad 20
06875,Villarino,26,189,178,367,edad 20
06875,Villarino,27,210,210,420,edad 20
06875,Villarino,28,174,163,337,edad 20
06875,Villarino,29,164,162,326,edad 20
06875,Villarino,30,204,165,369,edad 30
06875,Villarino,31,166,160,326,edad 30
06875,Villarino,32,160,161,321,edad 30
06875,Villarino,33,155,146,301,edad 30
06875,Villarino,34,171,138,309,edad 30
06875,Villarino,35,142,146,288,edad 30
06875,Villarino,36,168,168,336,edad 30
06875,Villarino,37,167,140,307,edad 30
06875,Villarino,38,161,151,312,edad 30
06875,Villarino,39,165,160,325,edad 30
06875,Villarino,40,169,153,322,edad 40
06875,Villarino,41,170,129,299,edad 40
06875,Villarino,42,149,147,296,edad 40
06875,Villarino,43,124,127,251,edad 40
06875,Villarino,44,131,137,268,edad 40
06875,Villarino,45,139,147,286,edad 40
06875,Villarino,46,122,131,253,edad 40
06875,Villarino,47,140,140,280,edad 40
06875,Villarino,48,156,134,290,edad 40
06875,Villarino,49,132,121,253,edad 40
06875,Villarino,50,145,133,278,edad 50
06875,Villarino,51,134,132,266,edad 50
06875,Villarino,52,139,124,263,edad 50
06875,Villarino,53,157,122,279,edad 50
06875,Villarino,54,125,112,237,edad 50
06875,Villarino,55,126,105,231,edad 50
06875,Villarino,56,124,99,223,edad 50
06875,Villarino,57,117,122,239,edad 50
06875,Villarino,58,102,99,201,edad 50
06875,Villarino,59,110,107,217,edad 50
06875,Villarino,60,130,106,236,edad 60
06875,Villarino,61,107,77,184,edad 60
06875,Villarino,62,108,72,180,edad 60
06875,Villarino,63,117,86,203,edad 60
06875,Villarino,64,106,91,197,edad 60
06875,Villarino,65,101,107,208,edad 60
06875,Villarino,66,81,78,159,edad 60
06875,Villarino,67,91,86,177,edad 60
06875,Villarino,68,84,86,170,edad 60
06875,Villarino,69,89,66,155,edad 60
06875,Villarino,70,86,83,169,edad 70
06875,Villarino,71,73,65,138,edad 70
06875,Villarino,72,71,79,150,edad 70
06875,Villarino,73,84,77,161,edad 70
06875,Villarino,74,66,64,130,edad 70
06875,Villarino,75,64,61,125,edad 70
06875,Villarino,76,51,73,124,edad 70
06875,Villarino,77,61,49,110,edad 70
06875,Villarino,78,34,58,92,edad 70
06875,Villarino,79,41,45,86,edad 70
06875,Villarino,80,34,39,73,edad 80
06875,Villarino,81,33,32,65,edad 80
06875,Villarino,82,31,36,67,edad 80
06875,Villarino,83,28,41,69,edad 80
06875,Villarino,84,13,32,45,edad 80
06875,Villarino,85,10,22,32,edad 80
06875,Villarino,86,14,19,33,edad 80
06875,Villarino,87,15,17,32,edad 80
06875,Villarino,88,6,18,24,edad 80
06875,Villarino,89,11,11,22,edad 80
06875,Villarino,90,8,6,14,edad 90
06875,Villarino,91,4,7,11,edad 90
06875,Villarino,92,2,7,9,edad 90
06875,Villarino,93,1,8,9,edad 90
06875,Villarino,94,4,2,6,edad 90
06875,Villarino,95,1,3,4,edad 90
06875,Villarino,96,0,1,1,edad 90
06875,Villarino,99,1,0,1,edad 90
06882,Zárate,0,1053,1015,2068,edad 0
06882,Zárate,1,848,873,1721,edad 0
06882,Zárate,2,1003,973,1976,edad 0
06882,Zárate,3,964,952,1916,edad 0
06882,Zárate,4,942,947,1889,edad 0
06882,Zárate,5,953,918,1871,edad 0
06882,Zárate,6,960,950,1910,edad 0
06882,Zárate,7,933,899,1832,edad 0
06882,Zárate,8,939,908,1847,edad 0
06882,Zárate,9,879,931,1810,edad 0
06882,Zárate,10,1035,990,2025,edad 10
06882,Zárate,11,934,911,1845,edad 10
06882,Zárate,12,955,887,1842,edad 10
06882,Zárate,13,947,866,1813,edad 10
06882,Zárate,14,984,919,1903,edad 10
06882,Zárate,15,910,874,1784,edad 10
06882,Zárate,16,827,919,1746,edad 10
06882,Zárate,17,927,812,1739,edad 10
06882,Zárate,18,893,875,1768,edad 10
06882,Zárate,19,972,925,1897,edad 10
06882,Zárate,20,962,874,1836,edad 20
06882,Zárate,21,986,953,1939,edad 20
06882,Zárate,22,935,911,1846,edad 20
06882,Zárate,23,918,923,1841,edad 20
06882,Zárate,24,863,858,1721,edad 20
06882,Zárate,25,775,755,1530,edad 20
06882,Zárate,26,760,745,1505,edad 20
06882,Zárate,27,731,752,1483,edad 20
06882,Zárate,28,754,705,1459,edad 20
06882,Zárate,29,749,734,1483,edad 20
06882,Zárate,30,746,738,1484,edad 30
06882,Zárate,31,671,659,1330,edad 30
06882,Zárate,32,694,711,1405,edad 30
06882,Zárate,33,641,631,1272,edad 30
06882,Zárate,34,548,593,1141,edad 30
06882,Zárate,35,626,639,1265,edad 30
06882,Zárate,36,652,671,1323,edad 30
06882,Zárate,37,577,627,1204,edad 30
06882,Zárate,38,606,663,1269,edad 30
06882,Zárate,39,617,634,1251,edad 30
06882,Zárate,40,572,651,1223,edad 40
06882,Zárate,41,647,600,1247,edad 40
06882,Zárate,42,643,652,1295,edad 40
06882,Zárate,43,608,614,1222,edad 40
06882,Zárate,44,558,529,1087,edad 40
06882,Zárate,45,580,578,1158,edad 40
06882,Zárate,46,514,546,1060,edad 40
06882,Zárate,47,563,523,1086,edad 40
06882,Zárate,48,530,552,1082,edad 40
06882,Zárate,49,524,483,1007,edad 40
06882,Zárate,50,548,530,1078,edad 50
06882,Zárate,51,555,508,1063,edad 50
06882,Zárate,52,536,497,1033,edad 50
06882,Zárate,53,497,515,1012,edad 50
06882,Zárate,54,454,491,945,edad 50
06882,Zárate,55,436,487,923,edad 50
06882,Zárate,56,510,479,989,edad 50
06882,Zárate,57,419,411,830,edad 50
06882,Zárate,58,378,438,816,edad 50
06882,Zárate,59,351,399,750,edad 50
06882,Zárate,60,354,384,738,edad 60
06882,Zárate,61,342,382,724,edad 60
06882,Zárate,62,357,369,726,edad 60
06882,Zárate,63,317,344,661,edad 60
06882,Zárate,64,317,311,628,edad 60
06882,Zárate,65,313,348,661,edad 60
06882,Zárate,66,306,346,652,edad 60
06882,Zárate,67,259,327,586,edad 60
06882,Zárate,68,274,343,617,edad 60
06882,Zárate,69,271,322,593,edad 60
06882,Zárate,70,255,369,624,edad 70
06882,Zárate,71,261,359,620,edad 70
06882,Zárate,72,245,321,566,edad 70
06882,Zárate,73,241,314,555,edad 70
06882,Zárate,74,204,308,512,edad 70
06882,Zárate,75,219,283,502,edad 70
06882,Zárate,76,176,300,476,edad 70
06882,Zárate,77,148,248,396,edad 70
06882,Zárate,78,185,227,412,edad 70
06882,Zárate,79,129,206,335,edad 70
06882,Zárate,80,106,212,318,edad 80
06882,Zárate,81,92,174,266,edad 80
06882,Zárate,82,88,149,237,edad 80
06882,Zárate,83,69,140,209,edad 80
06882,Zárate,84,78,111,189,edad 80
06882,Zárate,85,44,101,145,edad 80
06882,Zárate,86,46,83,129,edad 80
06882,Zárate,87,38,92,130,edad 80
06882,Zárate,88,32,69,101,edad 80
06882,Zárate,89,14,57,71,edad 80
06882,Zárate,90,9,48,57,edad 90
06882,Zárate,91,10,35,45,edad 90
06882,Zárate,92,6,15,21,edad 90
06882,Zárate,93,3,18,21,edad 90
06882,Zárate,94,1,11,12,edad 90
06882,Zárate,95,3,5,8,edad 90
06882,Zárate,96,2,8,10,edad 90
06882,Zárate,97,0,10,10,edad 90
06882,Zárate,98,0,1,1,edad 90
06882,Zárate,99,1,2,3,edad 90
06882,Zárate,0,123713,119193,242906,edad 0
06882,Zárate,1,113324,108959,222283,edad 0
06882,Zárate,2,125455,121480,246935,edad 0
06882,Zárate,3,121509,117304,238813,edad 0
06882,Zárate,4,123589,119094,242683,edad 0
06882,Zárate,5,128633,124636,253269,edad 0
06882,Zárate,6,125520,122255,247775,edad 0
06882,Zárate,7,123779,118853,242632,edad 0
06882,Zárate,8,124011,118976,242987,edad 0
06882,Zárate,9,124712,121804,246516,edad 0
06882,Zárate,10,132636,129119,261755,edad 10
06882,Zárate,11,129322,124585,253907,edad 10
06882,Zárate,12,125316,122086,247402,edad 10
06882,Zárate,13,124059,120125,244184,edad 10
06882,Zárate,14,123978,120908,244886,edad 10
06882,Zárate,15,121409,118734,240143,edad 10
06882,Zárate,16,117453,114334,231787,edad 10
06882,Zárate,17,115010,113013,228023,edad 10
06882,Zárate,18,116481,112494,228975,edad 10
06882,Zárate,19,120384,120335,240719,edad 10
06882,Zárate,20,121064,119020,240084,edad 20
06882,Zárate,21,125356,123959,249315,edad 20
06882,Zárate,22,121476,121127,242603,edad 20
06882,Zárate,23,119661,119396,239057,edad 20
06882,Zárate,24,116937,117485,234422,edad 20
06882,Zárate,25,110257,111226,221483,edad 20
06882,Zárate,26,105493,107877,213370,edad 20
06882,Zárate,27,102057,102939,204996,edad 20
06882,Zárate,28,101573,101516,203089,edad 20
06882,Zárate,29,96171,98853,195024,edad 20
06882,Zárate,30,103032,105795,208827,edad 30
06882,Zárate,31,93322,95272,188594,edad 30
06882,Zárate,32,90554,94221,184775,edad 30
06882,Zárate,33,88170,90638,178808,edad 30
06882,Zárate,34,82713,85137,167850,edad 30
06882,Zárate,35,85261,88647,173908,edad 30
06882,Zárate,36,85834,90078,175912,edad 30
06882,Zárate,37,82905,87325,170230,edad 30
06882,Zárate,38,86885,91031,177916,edad 30
06882,Zárate,39,81289,85486,166775,edad 30
06882,Zárate,40,84496,90525,175021,edad 40
06882,Zárate,41,83483,84362,167845,edad 40
06882,Zárate,42,85069,88536,173605,edad 40
06882,Zárate,43,81210,84304,165514,edad 40
06882,Zárate,44,74634,79235,153869,edad 40
06882,Zárate,45,79020,83747,162767,edad 40
06882,Zárate,46,75569,81231,156800,edad 40
06882,Zárate,47,74951,79387,154338,edad 40
06882,Zárate,48,74792,79358,154150,edad 40
06882,Zárate,49,70763,75338,146101,edad 40
06882,Zárate,50,76721,85333,162054,edad 50
06882,Zárate,51,72400,76468,148868,edad 50
06882,Zárate,52,72568,77087,149655,edad 50
06882,Zárate,53,69981,74658,144639,edad 50
06882,Zárate,54,64686,70695,135381,edad 50
06882,Zárate,55,62184,67835,130019,edad 50
06882,Zárate,56,66709,71420,138129,edad 50
06882,Zárate,57,57825,62717,120542,edad 50
06882,Zárate,58,55673,60894,116567,edad 50
06882,Zárate,59,49947,55474,105421,edad 50
06882,Zárate,60,53415,62359,115774,edad 60
06882,Zárate,61,48746,54734,103480,edad 60
06882,Zárate,62,48528,55588,104116,edad 60
06882,Zárate,63,46579,53957,100536,edad 60
06882,Zárate,64,44049,51227,95276,edad 60
06882,Zárate,65,46318,55182,101500,edad 60
06882,Zárate,66,40402,49712,90114,edad 60
06882,Zárate,67,40186,47714,87900,edad 60
06882,Zárate,68,39184,49506,88690,edad 60
06882,Zárate,69,37724,47441,85165,edad 60
06882,Zárate,70,39634,53208,92842,edad 70
06882,Zárate,71,36257,47800,84057,edad 70
06882,Zárate,72,34797,47694,82491,edad 70
06882,Zárate,73,32369,45177,77546,edad 70
06882,Zárate,74,29934,43482,73416,edad 70
06882,Zárate,75,28703,42299,71002,edad 70
06882,Zárate,76,26451,39721,66172,edad 70
06882,Zárate,77,23169,35173,58342,edad 70
06882,Zárate,78,22130,34968,57098,edad 70
06882,Zárate,79,18316,29441,47757,edad 70
06882,Zárate,80,16928,29942,46870,edad 80
06882,Zárate,81,14026,24111,38137,edad 80
06882,Zárate,82,11871,22413,34284,edad 80
06882,Zárate,83,9637,19189,28826,edad 80
06882,Zárate,84,8261,17251,25512,edad 80
06882,Zárate,85,7196,15454,22650,edad 80
06882,Zárate,86,6173,14412,20585,edad 80
06882,Zárate,87,5243,12900,18143,edad 80
06882,Zárate,88,4241,10149,14390,edad 80
06882,Zárate,89,3339,8262,11601,edad 80
06882,Zárate,90,2612,7090,9702,edad 90
06882,Zárate,91,1794,5232,7026,edad 90
06882,Zárate,92,1440,4077,5517,edad 90
06882,Zárate,93,1054,3106,4160,edad 90
06882,Zárate,94,693,2374,3067,edad 90
06882,Zárate,95,496,1604,2100,edad 90
06882,Zárate,96,365,1201,1566,edad 90
06882,Zárate,97,243,848,1091,edad 90
06882,Zárate,98,153,533,686,edad 90
06882,Zárate,99,153,427,580,edad 90
06882,Zárate,110,0,2,2,edad 110
